,Player,Team,Position,GP,TOI,Goals,Total Assists,First Assists,Second Assists,Total Points,IPP,Shots,SH%,Faceoffs Won,Faceoffs Lost,Faceoffs %
403,Nikita Kucherov,T.B,R,69,1359.766667,33,77,50,27,110,85.27,206,16.02,0,3,0
165,Patrick Kane,CHI,R,67,1513.016667,40,57,34,23,97,78.86,287,13.94,1,1,50
677,Connor McDavid,EDM,C,64,1466.716667,33,63,47,16,96,82.76,202,16.34,357,403,46.97
78,Sidney Crosby,PIT,C,65,1352.316667,31,56,42,14,87,73.11,189,16.4,808,663,54.93
566,Nathan MacKinnon,COL,C,69,1516.433333,35,52,30,22,87,70.73,297,11.78,448,572,43.92
605,Leon Draisaitl,EDM,C,68,1525.216667,41,45,27,18,86,74.78,190,21.58,581,574,50.3
687,Mikko Rantanen,COL,R,69,1441.233333,30,56,34,22,86,74.78,180,16.67,15,23,39.47
368,Johnny Gaudreau,CGY,L,68,1372.833333,30,54,33,21,84,73.68,205,14.63,1,2,33.33
59,Blake Wheeler,WPG,R,67,1410.433333,19,64,46,18,83,76.15,194,9.79,27,54,33.33
643,Brayden Point,T.B,C,67,1257.216667,37,45,25,20,82,68.33,168,22.02,357,344,50.93
714,Mitchell Marner,TOR,"C, R",68,1336.2,24,58,45,13,82,71.3,196,12.24,4,4,50
107,Brad Marchand,BOS,L,67,1327.45,28,53,30,23,81,70.43,193,14.51,40,57,41.24
184,Steven Stamkos,T.B,C,69,1257.65,34,45,29,16,79,74.53,199,17.09,416,373,52.72
56,Alex Ovechkin,WSH,L,67,1395.683333,46,31,21,10,77,65.81,272,16.91,1,4,20
690,Sebastian Aho,CAR,"C, R",68,1361.3,30,47,27,20,77,72.64,208,14.42,468,498,48.45
236,John Tavares,TOR,C,68,1296.85,38,38,22,16,76,67.26,238,15.97,696,579,54.59
410,Mark Scheifele,WPG,C,67,1489.1,32,43,25,18,75,64.1,166,19.28,668,786,45.94
567,Aleksander Barkov,FLA,C,68,1542.716667,29,46,29,17,75,65.79,174,16.67,889,760,53.91
39,Brent Burns,S.J,D,68,1692.4,13,60,34,26,73,59.84,250,5.2,0,1,0
119,Claude Giroux,PHI,C,68,1445.666667,20,53,31,22,73,70.19,191,10.47,584,403,59.17
726,Artemi Panarin,CBJ,L,65,1308.733333,25,48,34,14,73,74.49,169,14.79,1,1,50
406,Jonathan Huberdeau,FLA,L,68,1284.566667,21,51,30,21,72,75.79,184,11.41,10,7,58.82
570,Elias Lindholm,CGY,C,68,1380.816667,26,46,25,21,72,63.16,165,15.76,440,378,53.79
571,Sean Monahan,CGY,C,68,1325.866667,30,42,24,18,72,66.67,191,15.71,410,402,50.49
678,Jack Eichel,BUF,C,65,1323.483333,25,47,28,19,72,72,259,9.65,512,551,48.17
131,Jonathan Toews,CHI,C,68,1427.483333,29,40,26,14,69,63.3,188,15.43,865,683,55.88
405,Gabriel Landeskog,COL,L,68,1434.316667,33,36,18,18,69,60.53,230,14.35,337,314,51.77
57,Evgeni Malkin,PIT,C,62,1165.45,21,47,29,18,68,80.95,171,12.28,341,421,44.75
124,Phil Kessel,PIT,R,68,1229.383333,22,46,25,21,68,80,176,12.5,4,5,44.44
232,Ryan O'Reilly,STL,C,68,1424.516667,26,40,22,18,66,70.97,187,13.9,915,692,56.94
349,Mark Stone,"OTT, VGK",R,65,1321.683333,29,37,25,12,66,66.67,165,17.58,26,33,44.07
626,David Pastrnak,BOS,R,56,1065.6,31,35,21,14,66,73.33,206,15.05,1,2,33.33
765,Alex DeBrincat,CHI,"L, R",68,1197.916667,37,29,15,14,66,68.04,191,19.37,16,18,47.06
409,Mika Zibanejad,NYR,C,68,1395.133333,27,38,20,18,65,76.47,201,13.43,689,698,49.68
441,Morgan Rielly,TOR,D,68,1551.366667,18,47,22,25,65,50,180,10,0,1,0
126,Nicklas Backstrom,WSH,C,67,1341.583333,17,47,28,19,64,66.67,149,11.41,592,612,49.17
411,Sean Couturier,PHI,C,66,1448.366667,28,36,24,12,64,62.75,180,15.56,614,460,57.17
45,Patrice Bergeron,BOS,C,52,975.8833333,25,38,21,17,63,68.48,165,15.15,648,482,57.35
218,Cam Atkinson,CBJ,R,66,1299.2,38,25,10,15,63,69.23,257,14.79,18,45,28.57
458,Teuvo Teravainen,CAR,L,68,1218.716667,18,45,29,16,63,76.83,141,12.77,14,20,41.18
531,Jake Guentzel,PIT,"C, L",68,1299.266667,33,30,15,15,63,67.02,183,18.03,10,20,33.33
755,Matthew Tkachuk,CGY,L,68,1193.766667,26,37,23,14,63,68.48,169,15.38,5,6,45.45
55,Mark Giordano,CGY,D,66,1626.55,14,48,20,28,62,49.6,182,7.69,0,0,-
238,Matt Duchene,"CBJ, OTT",C,59,1127.866667,28,34,22,12,62,69.66,146,19.18,558,443,55.74
328,Tyler Seguin,DAL,C,68,1419,27,35,25,10,62,68.89,267,10.11,548,471,53.78
617,Dylan Larkin,DET,C,65,1420.55,27,35,22,13,62,80.52,247,10.93,754,620,54.88
52,Joe Pavelski,S.J,C,68,1304.216667,36,25,16,9,61,65.59,172,20.93,484,431,52.9
151,Logan Couture,S.J,C,68,1273.033333,23,38,23,15,61,63.54,167,13.77,242,270,47.27
171,Jakub Voracek,PHI,R,66,1228.55,18,43,28,15,61,72.62,178,10.11,10,15,40
457,Tomas Hertl,S.J,C,63,1190.383333,30,31,18,13,61,64.89,142,21.13,485,435,52.72
228,Mike Hoffman,FLA,L,68,1226.283333,31,29,11,18,60,65.93,215,14.42,10,20,33.33
304,Evgeny Kuznetsov,WSH,C,62,1164.916667,17,43,21,22,60,65.22,165,10.3,325,525,38.24
576,Max Domi,MTL,"C, L",69,1203.016667,22,38,23,15,60,77.92,163,13.5,394,488,44.67
758,Auston Matthews,TOR,C,54,989.7333333,30,30,19,11,60,78.95,182,16.48,397,366,52.03
68,David Krejci,BOS,C,68,1204.05,18,41,26,15,59,78.67,120,15,462,482,48.94
198,John Carlson,WSH,D,67,1686.316667,10,49,31,18,59,44.03,151,6.62,0,0,-
317,Vladimir Tarasenko,STL,R,66,1219.466667,28,30,14,16,58,74.36,235,11.91,4,2,66.67
322,Jeff Skinner,BUF,"C, L",68,1267.95,36,22,14,8,58,61.7,222,16.22,128,120,51.61
404,Ryan Nugent-Hopkins,EDM,C,68,1380.733333,22,36,16,20,58,66.67,179,12.29,306,358,46.08
604,Sam Reinhart,BUF,C,68,1284.066667,18,40,28,12,58,66.67,152,11.84,25,46,35.21
822,Elias Pettersson,VAN,C,58,1068.533333,26,32,22,10,58,78.38,119,21.85,227,327,40.97
683,Timo Meier,S.J,R,65,1107.183333,26,31,16,15,57,74.03,215,12.09,11,23,32.35
36,Zach Parise,MIN,L,67,1249.216667,24,31,16,15,55,72.37,212,11.32,7,21,25
61,Alexander Radulov,DAL,R,56,1102.6,21,34,19,15,55,67.9,161,13.04,6,8,42.86
327,Ryan Johansen,NSH,C,68,1342.95,11,44,27,17,55,64.71,123,8.94,701,591,54.26
698,Mathew Barzal,NYI,C,68,1223.4,17,38,17,21,55,85.94,149,11.41,191,272,41.25
93,Keith Yandle,FLA,D,68,1542.016667,9,45,31,14,54,48.65,171,5.26,0,0,-
200,Roman Josi,NSH,D,70,1766.666667,15,39,21,18,54,58.7,241,6.22,0,0,-
784,Pierre-Luc Dubois,CBJ,C,68,1228.983333,23,31,16,15,54,60,144,15.97,394,507,43.73
91,Kris Letang,PIT,D,60,1555.333333,15,38,24,14,53,48.62,188,7.98,0,0,-
167,Evgenii Dadonov,FLA,R,68,1252.6,22,31,17,14,53,54.08,165,13.33,2,3,40
673,Kyle Connor,WPG,L,67,1288.4,26,26,15,11,52,51.49,189,13.76,3,4,42.86
239,Evander Kane,S.J,L,64,1172.133333,27,24,12,12,51,67.11,235,11.49,80,110,42.11
330,Mikael Granlund,"MIN, NSH","C, R",67,1249.733333,16,35,25,10,51,78.46,169,9.47,114,142,44.53
190,Josh Bailey,NYI,R,68,1156.083333,14,36,25,11,50,73.53,103,13.59,132,122,51.97
212,Gustav Nyquist,"DET, S.J","C, R",67,1205.65,17,33,18,15,50,70.42,178,9.55,8,10,44.44
568,Jonathan Drouin,MTL,"C, L",68,1186.3,17,33,26,7,50,69.44,170,10,37,48,43.53
249,Chris Kreider,NYR,L,68,1201.783333,26,23,11,12,49,54.44,179,14.53,16,36,30.77
574,Bo Horvat,VAN,C,69,1448.883333,24,25,11,14,49,60.49,200,12,912,805,53.12
81,Anze Kopitar,L.A,C,67,1495.566667,19,29,22,7,48,63.16,131,14.5,828,675,55.09
231,Kyle Palmieri,N.J,R,65,1205.616667,26,22,15,7,48,61.54,202,12.87,21,58,26.58
253,Tomas Tatar,MTL,L,67,1094.716667,22,26,18,8,48,73.85,170,12.94,10,26,27.78
433,Torey Krug,BOS,D,57,1215.566667,6,42,23,19,48,55.81,134,4.48,0,0,-
495,Erik Gustafsson,CHI,D,65,1446.583333,13,35,22,13,48,53.33,120,10.83,0,0,-
710,Thomas Chabot,OTT,D,61,1467.333333,13,35,11,24,48,46.6,163,7.98,0,0,-
28,Eric Staal,MIN,C,68,1220.65,19,28,16,12,47,61.04,182,10.44,526,506,50.97
254,Tyson Barrie,COL,D,65,1411.65,7,40,25,15,47,52.22,178,3.93,0,0,-
315,Kevin Hayes,"NYR, WPG","C, R",56,1074.083333,16,31,16,15,47,78.33,129,12.4,409,426,48.98
359,Ryan Dzingel,"CBJ, OTT","C, L",64,1100.933333,22,25,17,8,47,66.2,139,15.83,39,55,41.49
428,Jonathan Marchessault,VGK,C,69,1274.316667,20,27,14,13,47,61.84,241,8.3,85,148,36.48
620,Alex Tuch,VGK,R,61,1035.716667,18,29,12,17,47,66.2,145,12.41,38,67,36.19
697,Brock Boeser,VAN,R,56,1078.183333,22,25,13,12,47,62.67,172,12.79,21,28,42.86
139,Jamie Benn,DAL,L,65,1176.233333,25,21,12,9,46,62.16,158,15.82,174,191,47.67
424,Phillip Danault,MTL,C,68,1207.033333,11,35,23,12,46,65.71,107,10.28,727,603,54.66
659,Kevin Labanc,S.J,R,68,932.4333333,12,34,18,16,46,70.77,106,11.32,6,11,35.29
694,Dylan Strome,"ARI, CHI",C,64,1032.816667,17,29,13,16,46,56.79,120,14.17,375,390,49.02
192,Erik Karlsson,S.J,D,52,1275.833333,3,42,21,21,45,48.91,167,1.8,0,1,0
341,Brendan Gallagher,MTL,R,69,1135.666667,30,15,7,8,45,61.64,250,12,19,27,41.3
766,Patrik Laine,WPG,R,67,1144.383333,29,16,13,3,45,55.56,218,13.3,11,18,37.93
8,Justin Williams,CAR,R,68,1169.883333,20,24,14,10,44,60.27,200,10,81,131,38.21
30,Ryan Suter,MIN,D,69,1855.8,7,37,12,25,44,44,116,6.03,1,0,100
240,Brayden Schenn,STL,C,58,1085.6,13,31,22,9,44,65.67,119,10.92,314,353,47.08
310,Brock Nelson,NYI,C,68,1230.05,21,23,10,13,44,70.97,147,14.29,503,534,48.51
331,Nino Niederreiter,"CAR, MIN",R,68,1072.416667,20,24,14,10,44,62.86,153,13.07,34,26,56.67
767,Clayton Keller,ARI,C,68,1256.866667,13,31,18,13,44,68.75,167,7.78,27,50,35.06
819,Nico Hischier,N.J,C,62,1124.15,17,27,12,15,44,57.89,142,11.97,397,487,44.91
65,Carl Soderberg,COL,C,69,1180.3,21,22,13,9,43,75.44,161,13.04,449,450,49.94
237,Victor Hedman,T.B,D,61,1386.816667,9,34,16,18,43,42.57,156,5.77,0,1,0
276,Anders Lee,NYI,L,68,1165.75,23,20,14,6,43,58.9,176,13.07,60,60,50
401,William Karlsson,VGK,C,69,1314.5,19,24,12,12,43,66.15,147,12.93,495,533,48.15
693,Travis Konecny,PHI,"C, R",68,1033.983333,22,21,12,9,43,71.67,150,14.67,5,13,27.78
84,T.J. Oshie,WSH,R,57,1064.4,21,21,10,11,42,53.85,123,17.07,72,100,41.86
260,Mattias Ekholm,NSH,D,68,1586.583333,8,34,17,17,42,56,127,6.3,0,0,-
476,Chris Tierney,OTT,C,69,1187.866667,7,35,21,14,42,70,102,6.86,478,457,51.12
624,Kasperi Kapanen,TOR,R,68,1126.566667,19,23,11,12,42,60.87,147,12.93,5,3,62.5
118,Jeff Petry,MTL,D,69,1594.916667,11,30,15,15,41,48.24,139,7.91,0,1,0
252,Reilly Smith,VGK,R,62,1145.533333,13,28,19,9,41,63.08,151,8.61,5,2,71.43
462,Filip Forsberg,NSH,L,52,977.5333333,22,19,13,6,41,66.13,180,12.22,0,5,0
490,Andreas Athanasiou,DET,C,62,1019.8,23,18,12,6,41,70.69,175,13.14,87,134,39.37
615,Jakub Vrana,WSH,L,68,961.7166667,19,22,14,8,41,69.49,131,14.5,4,4,50
3,Joe Thornton,S.J,C,59,912.6,14,26,16,10,40,64.52,71,19.72,284,240,54.2
105,Bryan Little,WPG,C,67,1064.566667,14,26,16,10,40,67.8,109,12.84,464,419,52.55
227,Tyler Johnson,T.B,C,67,1086.266667,22,18,9,9,40,50.63,135,16.3,204,217,48.46
569,Seth Jones,CBJ,D,61,1582.6,9,31,15,16,40,45.98,154,5.84,0,0,-
38,Ryan Getzlaf,ANA,C,58,1145.766667,11,28,11,17,39,75,122,9.02,475,398,54.41
62,Travis Zajac,N.J,C,67,1302.133333,15,24,8,16,39,61.9,104,14.42,706,516,57.77
168,Mikael Backlund,CGY,C,64,1139.583333,17,22,16,6,39,60.94,161,10.56,436,448,49.32
219,Jared Spurgeon,MIN,D,69,1653.05,12,27,13,14,39,44.83,131,9.16,0,0,-
291,Mats Zuccarello,"DAL, NYR","C, R",47,934.4833333,12,27,16,11,39,66.1,103,11.65,10,20,33.33
438,Yanni Gourde,T.B,C,69,1114.5,18,21,13,8,39,60,120,15,142,115,55.25
573,Rasmus Ristolainen,BUF,D,68,1694.166667,5,34,20,14,39,49.37,162,3.09,0,0,-
650,Viktor Arvidsson,NSH,"L, R",46,888.4166667,28,11,4,7,39,63.93,154,18.18,2,15,11.76
34,Dustin Brown,L.A,R,58,1180.466667,16,22,15,7,38,60.32,141,11.35,0,14,0
183,Drew Doughty,L.A,D,68,1822.633333,5,33,17,16,38,55.07,133,3.76,0,0,-
394,Brandon Saad,CHI,L,66,1163.35,21,17,12,5,38,62.3,162,12.96,18,34,34.62
460,Jacob Trouba,WPG,D,67,1524.883333,5,33,12,21,38,40.86,128,3.91,0,0,-
79,Bobby Ryan,OTT,R,66,1041.833333,13,24,16,8,37,67.27,137,9.49,6,14,30
148,James van Riemsdyk,PHI,L,52,828.8666667,20,17,7,10,37,67.27,118,16.95,6,5,54.55
244,Ryan Ellis,NSH,D,70,1694.8,6,31,15,16,37,39.36,131,4.58,0,0,-
296,Jason Zucker,MIN,L,68,1166.9,20,17,11,6,37,64.91,186,10.75,1,4,20
325,Taylor Hall,N.J,L,33,649.6666667,11,26,18,8,37,77.08,113,9.73,26,32,44.83
856,Rasmus Dahlin,BUF,D,68,1432.583333,8,29,9,20,37,45.12,142,5.63,0,0,-
170,Max Pacioretty,VGK,L,56,967.3333333,21,15,11,4,36,69.23,166,12.65,16,31,34.04
208,Adam Henrique,ANA,C,69,1147.766667,16,20,13,7,36,60,109,14.68,494,432,53.35
241,Oliver Ekman-Larsson,ARI,D,67,1588.9,9,27,16,11,36,49.32,148,6.08,0,0,-
242,Nazem Kadri,TOR,C,60,974.0666667,15,21,11,10,36,60,152,9.87,304,263,53.62
326,Brett Connolly,WSH,R,68,905.6666667,17,19,10,9,36,70.59,111,15.32,8,19,29.63
417,J.T. Miller,T.B,C,63,914.3333333,12,24,10,14,36,53.73,94,12.77,205,228,47.34
440,Alex Galchenyuk,ARI,C,58,926.2166667,15,21,11,10,36,78.26,129,11.63,172,202,45.99
496,Josh Anderson,CBJ,R,68,1154.366667,22,14,7,7,36,60,193,11.4,8,13,38.1
518,Andreas Johnsson,TOR,L,61,806.2333333,19,17,8,9,36,67.92,104,18.27,7,12,36.84
704,Zach Werenski,CBJ,D,68,1542.166667,9,27,16,11,36,46.75,139,6.47,0,0,-
850,Brady Tkachuk,OTT,L,58,901.0833333,16,20,14,6,36,64.29,165,9.7,42,45,48.28
161,David Perron,STL,L,45,769.8,17,18,11,7,35,77.78,85,20,15,18,45.45
347,John Klingberg,DAL,D,50,1228.816667,9,26,8,18,35,52.24,126,7.14,0,0,-
348,Micheal Ferland,CAR,L,58,825.4833333,17,18,14,4,35,59.32,131,12.98,21,48,30.43
374,Andrew Shaw,MTL,R,50,792.5,17,18,12,6,35,72.92,101,16.83,139,164,45.87
675,Colin White,OTT,C,63,1004.95,13,22,11,11,35,64.81,111,11.71,347,380,47.73
4,Patrick Marleau,TOR,C,68,1123.583333,14,20,14,6,34,53.13,131,10.69,95,86,52.49
169,Ryan McDonagh,T.B,D,69,1508.9,8,26,9,17,34,40,109,7.34,0,0,-
268,Cody Eakin,VGK,C,65,1008.916667,17,17,12,5,34,64.15,101,16.83,394,378,51.04
456,Tom Wilson,WSH,R,49,890.2666667,19,15,6,9,34,60.71,104,18.27,25,19,56.82
475,Jimmy Vesey,NYR,L,67,1085.133333,16,18,14,4,34,66.67,133,12.03,5,16,23.81
479,Damon Severson,N.J,D,69,1500.666667,10,24,13,11,34,47.22,117,8.55,0,0,-
505,Alexander Kerfoot,COL,C,65,921.75,11,23,11,12,34,70.83,89,12.36,225,187,54.61
572,Darnell Nurse,EDM,D,68,1631.7,8,26,10,16,34,40.48,165,4.85,0,0,-
613,Kevin Fiala,"MIN, NSH",L,70,1068.166667,12,22,13,9,34,75.56,146,8.22,3,3,50
669,Frank Vatrano,FLA,C,67,985.8666667,20,14,6,8,34,69.39,166,12.05,14,22,38.89
719,Jake DeBrusk,BOS,L,57,915.9166667,22,12,6,6,34,58.62,138,15.94,8,24,25
25,Duncan Keith,CHI,D,68,1555.7,4,29,10,19,33,38.37,118,3.39,0,0,-
136,Alex Killorn,T.B,L,69,1043.6,13,20,15,5,33,58.93,132,9.85,2,6,25
335,Joonas Donskoi,S.J,R,68,932.1666667,14,19,10,9,33,61.11,103,13.59,1,8,11.11
563,Tyler Bertuzzi,DET,L,59,946.9833333,16,17,8,9,33,61.11,98,16.33,10,19,34.48
583,Anthony Mantha,DET,R,53,928.5833333,17,16,10,6,33,66,154,11.04,18,22,45
787,Jesper Bratt,N.J,L,51,773.55,8,25,14,11,33,80.49,91,8.79,4,3,57.14
21,Frans Nielsen,DET,C,63,1064.266667,9,23,9,14,32,60.38,108,8.33,401,417,49.02
29,Thomas Vanek,DET,L,57,805.4833333,13,19,11,8,32,64,90,14.44,7,16,30.43
77,Paul Stastny,VGK,C,39,702.8666667,9,23,11,12,32,66.67,83,10.84,363,291,55.5
172,Jake Muzzin,"L.A, TOR",D,69,1450.433333,6,26,12,14,32,48.48,110,5.45,0,0,-
185,Alex Pietrangelo,STL,D,57,1358.866667,12,20,6,14,32,37.65,135,8.89,0,1,0
204,Derek Stepan,ARI,C,64,1234.416667,13,19,15,4,32,55.17,180,7.22,567,651,46.55
323,Zach Hyman,TOR,"C, L",58,1008.05,16,16,8,8,32,52.46,115,13.91,88,103,46.07
543,Shea Theodore,VGK,D,68,1364.483333,11,21,13,8,32,51.61,176,6.25,1,0,100
579,Ryan Pulock,NYI,D,68,1513.6,7,25,13,12,32,43.84,144,4.86,0,0,-
611,Nikolaj Ehlers,WPG,L,47,756.4,17,15,8,7,32,76.19,125,13.6,1,1,50
854,Jesperi Kotkaniemi,MTL,C,67,943.9666667,11,21,13,8,32,76.19,113,9.73,321,385,45.47
101,Patric Hornqvist,PIT,R,55,842.6,16,15,5,10,31,50,143,11.19,4,9,30.77
128,Artem Anisimov,CHI,C,64,1033.1,13,18,12,6,31,67.39,118,11.02,266,304,46.67
175,Lars Eller,WSH,C,67,1111.383333,9,22,12,10,31,60.78,140,6.43,444,453,49.5
189,Mikkel Boedker,OTT,L,61,888.5333333,6,25,13,12,31,59.62,78,7.69,7,11,38.89
211,TJ Brodie,CGY,D,67,1451.216667,8,23,11,12,31,37.8,89,8.99,0,1,0
263,Craig Smith,NSH,R,64,973.8833333,18,13,9,4,31,60.78,182,9.89,26,28,48.15
334,Bryan Rust,PIT,R,62,963.6166667,17,14,8,6,31,60.78,123,13.82,7,14,33.33
379,Blake Coleman,N.J,C,65,1091.566667,19,12,8,4,31,63.27,177,10.73,106,138,43.44
391,Boone Jenner,CBJ,C,64,1120.1,12,19,14,5,31,60.78,150,8,547,459,54.37
577,Josh Morrissey,WPG,D,59,1321.9,6,25,9,16,31,40.79,95,6.32,0,0,-
592,Conor Sheary,BUF,L,64,939.05,12,19,9,10,31,65.96,116,10.34,16,12,57.14
619,Travis Sanheim,PHI,D,68,1286.8,9,22,10,12,31,45.59,99,9.09,0,0,-
862,Dominik Kahun,CHI,C,68,988.9333333,11,20,16,4,31,59.62,116,9.48,20,31,39.22
12,Ilya Kovalchuk,L.A,L,57,942.0333333,14,16,11,5,30,71.43,127,11.02,14,20,41.18
54,Dustin Byfuglien,WPG,D,37,904.1166667,4,26,7,19,30,52.63,105,3.81,0,0,-
196,Jordan Eberle,NYI,"C, R",64,1057.8,13,17,11,6,30,55.56,131,9.92,3,5,37.5
226,Antoine Roussel,VAN,L,64,888.9,9,21,17,4,30,76.92,83,10.84,17,17,50
234,Alex Chiasson,EDM,R,59,1012.433333,19,11,9,2,30,47.62,98,19.39,7,10,41.18
235,Jakob Silfverberg,ANA,R,60,1012.766667,18,12,6,6,30,81.08,133,13.53,12,19,38.71
265,Casey Cizikas,NYI,C,61,831.55,19,11,9,2,30,75,93,20.43,405,414,49.45
426,Rickard Rakell,ANA,"C, L",56,1028.966667,11,19,13,6,30,60,152,7.24,17,29,36.96
470,Shayne Gostisbehere,PHI,D,65,1295.933333,6,24,10,14,30,43.48,156,3.85,0,0,-
500,Vinnie Hinostroza,ARI,C,58,861.75,11,19,10,9,30,83.33,108,10.19,27,52,34.18
550,J.T. Compher,COL,L,53,888.1833333,15,15,8,7,30,53.57,100,15,251,234,51.75
603,Aaron Ekblad,FLA,D,68,1604.116667,12,18,3,15,30,33.71,148,8.11,0,0,-
14,Mikko Koivu,MIN,C,48,878.2666667,8,21,15,6,29,67.44,89,8.99,488,406,54.59
108,Nick Foligno,CBJ,L,63,1136.766667,16,13,6,7,29,47.54,123,13.01,124,96,56.36
142,Nick Bonino,NSH,C,69,1126.733333,15,14,9,5,29,51.79,102,14.71,501,487,50.71
194,Jake Gardiner,TOR,D,60,1271.833333,2,27,13,14,29,38.16,75,2.67,0,1,0
229,Tyler Bozak,STL,C,59,973.75,11,18,8,10,29,64.44,113,9.73,378,312,54.78
259,Richard Panik,ARI,R,62,1030.616667,11,18,11,7,29,59.18,111,9.91,4,11,26.67
412,Dougie Hamilton,CAR,D,68,1333.966667,12,17,9,8,29,43.28,209,5.74,0,1,0
439,Ryan Murray,CBJ,D,56,1200.6,1,28,13,15,29,42.03,71,1.41,0,0,-
468,Esa Lindell,DAL,D,68,1665.55,9,20,8,12,29,45.31,109,8.26,0,0,-
612,Nick Ritchie,ANA,L,51,775.5,9,20,14,6,29,67.44,77,11.69,4,6,40
638,Brandon Montour,"ANA, BUF",D,68,1530.616667,7,22,7,15,29,51.79,143,4.9,0,0,-
671,Noah Hanifin,CGY,D,68,1419.233333,5,24,8,16,29,42.03,101,4.95,0,0,-
723,Anthony Cirelli,T.B,C,69,1019.45,13,16,10,6,29,58,105,12.38,436,379,53.5
855,Andrei Svechnikov,CAR,R,68,993.2666667,15,14,6,8,29,59.18,156,9.62,1,6,14.29
17,Jason Pominville,BUF,R,62,776.1333333,15,13,7,6,28,66.67,113,13.27,12,15,44.44
19,Valtteri Filppula,NYI,C,66,945.5833333,15,13,9,4,28,63.64,68,22.06,370,385,49.01
176,Wayne Simmonds,"NSH, PHI",R,67,1091.316667,16,12,10,2,28,53.85,142,11.27,4,12,25
230,Marcus Johansson,"BOS, N.J",L,52,836.8166667,12,16,10,6,28,65.12,107,11.21,15,33,31.25
297,Tyler Toffoli,L.A,R,68,1180.716667,12,16,9,7,28,59.57,192,6.25,23,17,57.5
305,Charlie Coyle,"BOS, MIN",C,67,1125.4,10,18,9,9,28,50,122,8.2,259,295,46.75
319,Jaden Schwartz,STL,L,55,1012.433333,6,22,13,9,28,62.22,146,4.11,18,19,48.65
360,Ondrej Palat,T.B,L,51,773.8,7,21,10,11,28,52.83,82,8.54,2,15,11.76
489,Jaccob Slavin,CAR,D,68,1557.766667,6,22,8,14,28,41.18,117,5.13,0,0,-
530,Pavel Buchnevich,NYR,R,51,747.4666667,15,13,7,6,28,71.79,89,16.85,7,17,29.17
679,Vince Dunn,STL,D,64,1085.833333,9,19,10,9,28,45.16,125,7.2,0,1,0
827,Miro Heiskanen,DAL,D,68,1568.633333,10,18,10,8,28,43.75,150,6.67,0,0,-
833,Alex Iafallo,L.A,L,68,1146.383333,14,14,8,6,28,59.57,129,10.85,5,17,22.73
13,Jason Spezza,DAL,C,66,904.95,8,19,11,8,27,54,98,8.16,423,296,58.83
33,Jeff Carter,L.A,C,62,1123.666667,10,17,7,10,27,57.45,140,7.14,486,459,51.43
46,Shea Weber,MTL,D,45,1072.3,11,16,6,10,27,49.09,119,9.24,0,0,-
149,Paul Byron,MTL,L,46,692.8833333,13,14,8,6,27,64.29,78,16.67,12,23,34.29
309,Justin Faulk,CAR,D,68,1515.933333,8,19,12,7,27,30.34,180,4.44,0,0,-
425,Vladislav Namestnikov,NYR,C,64,994.45,10,17,11,6,27,54,100,10,20,29,40.82
514,Nate Schmidt,VGK,D,49,1086.9,9,18,9,9,27,38.03,97,9.28,0,0,-
625,Jared McCann,"FLA, PIT",C,64,899.95,14,13,10,3,27,62.79,111,12.61,260,305,46.02
628,Nikolay Goldobin,VAN,R,60,897.05,7,20,10,10,27,57.45,100,7,0,0,-
655,Oskar Lindblom,PHI,L,67,872.4,12,15,12,3,27,65.85,131,9.16,3,6,33.33
812,Nolan Patrick,PHI,C,60,882.4833333,13,14,4,10,27,64.29,100,13,322,309,51.03
63,Mike Green,DET,D,43,932.3,5,21,7,14,26,55.32,92,5.43,0,0,-
375,Vincent Trocheck,FLA,C,41,818.95,7,19,10,9,26,56.52,116,6.03,375,344,52.16
427,Colin Miller,VGK,D,54,1077.966667,3,23,12,11,26,45.61,116,2.59,0,0,-
449,Scott Laughton,PHI,C,68,1000.483333,10,16,9,7,26,66.67,100,10,276,213,56.44
651,Danton Heinen,BOS,C,64,878.95,9,17,13,4,26,61.9,96,9.38,2,8,20
725,Evan Rodrigues,BUF,L,62,972.4166667,8,18,14,4,26,59.09,137,5.84,238,263,47.5
110,Kyle Okposo,BUF,R,64,891.8833333,11,14,9,5,25,62.5,122,9.02,59,65,47.58
152,P.K. Subban,NSH,D,51,1144.45,7,18,9,9,25,43.86,133,5.26,0,0,-
337,Marcus Sorensen,S.J,L,66,831.5,15,10,7,3,25,59.52,81,18.52,10,16,38.46
408,Ryan Strome,"EDM, NYR",C,67,1011.466667,13,12,8,4,25,58.14,87,14.94,315,328,48.99
450,Mark Jankowski,CGY,C,65,832.3333333,10,15,9,6,25,75.76,82,12.2,348,309,52.97
467,Oskar Sundqvist,STL,C,60,799.45,12,13,8,5,25,80.65,91,13.19,149,221,40.27
472,Devin Shore,"ANA, DAL",C,63,890.0833333,8,17,10,7,25,71.43,61,13.11,52,72,41.94
481,Colton Sissons,NSH,C,63,1020.8,11,14,7,7,25,48.08,87,12.64,346,320,51.95
522,Will Butcher,N.J,D,67,1291.666667,4,21,10,11,25,33.78,93,4.3,0,0,-
535,Oliver Bjorkstrand,CBJ,R,63,773.2166667,14,11,10,1,25,64.1,120,11.67,5,7,41.67
561,Artturi Lehkonen,MTL,L,69,1061.7,8,17,11,6,25,55.56,144,5.56,4,14,22.22
621,Tony DeAngelo,NYR,D,49,937.5333333,4,21,8,13,25,44.64,93,4.3,0,0,-
622,Nick Schmaltz,"ARI, CHI",C,40,713.2333333,7,18,9,9,25,60.98,62,11.29,104,177,37.01
646,Lucas Wallmark,CAR,C,67,1008.883333,8,17,8,9,25,64.1,115,6.96,488,472,50.83
720,Ivan Provorov,PHI,D,68,1703.416667,7,18,5,13,25,31.25,123,5.69,0,1,0
730,Derek Ryan,CGY,C,67,888.2,7,18,12,6,25,65.79,74,9.46,321,246,56.61
823,Robert Thomas,STL,C,56,707.1,7,18,9,9,25,75.76,64,10.94,91,114,44.39
35,Brent Seabrook,CHI,D,64,1254.033333,5,19,7,12,24,41.38,141,3.55,0,0,-
67,Alex Goligoski,ARI,D,62,1292.8,3,21,11,10,24,43.64,81,3.7,0,0,-
191,Tyler Myers,WPG,D,65,1307.916667,8,16,8,8,24,33.33,127,6.3,0,0,-
214,Matt Calvert,COL,L,69,974.3666667,10,14,10,4,24,61.54,122,8.2,35,49,41.67
248,Nick Leddy,NYI,D,68,1484.05,3,21,14,7,24,31.58,92,3.26,0,0,-
292,Calle Jarnkrok,NSH,C,67,1066.733333,10,14,7,7,24,50,98,10.2,155,153,50.32
377,Nick Cousins,ARI,C,68,927.7,6,18,11,7,24,64.86,119,5.04,187,216,46.4
442,Hampus Lindholm,ANA,D,63,1526.116667,5,19,7,12,24,41.38,109,4.59,0,0,-
463,Radek Faksa,DAL,C,67,1099.083333,12,12,9,3,24,61.54,92,13.04,467,463,50.22
606,Sam Bennett,CGY,C,66,888.95,11,13,10,3,24,58.54,106,10.38,50,37,57.47
630,Adrian Kempe,L.A,C,67,948.3166667,11,13,7,6,24,72.73,100,11,260,351,42.55
736,Dominik Simon,PIT,C,57,753.9833333,7,17,11,6,24,61.54,96,7.29,6,11,35.29
754,Brandon Tanev,WPG,L,67,956.6166667,13,11,9,2,24,80,111,11.71,3,5,37.5
788,Mikhail Sergachev,T.B,D,63,1107.266667,5,19,12,7,24,40,108,4.63,1,1,50
41,Brian Boyle,"N.J, NSH",C,61,841.6333333,17,6,4,2,23,45.1,109,15.6,150,140,51.72
86,Matt Niskanen,WSH,D,66,1455.766667,8,15,7,8,23,44.23,108,7.41,0,0,-
127,Michael Frolik,CGY,R,51,660.1666667,13,10,6,4,23,65.71,102,12.75,10,17,37.04
132,Mathieu Perreault,WPG,"C, L",67,838.0333333,11,12,5,7,23,54.76,78,14.1,26,27,49.06
146,Kevin Shattenkirk,NYR,D,59,1096.2,2,21,10,11,23,48.94,118,1.69,0,0,-
180,Zack Smith,OTT,L,60,980.9333333,8,15,11,4,23,67.65,90,8.89,367,385,48.8
444,Pontus Aberg,"ANA, MIN",L,52,774.5833333,12,11,5,6,23,60.53,92,13.04,2,13,13.33
452,Mike Matheson,FLA,D,62,1380.5,7,16,9,7,23,41.82,108,6.48,0,1,0
503,Connor Brown,TOR,R,68,965.95,5,18,11,7,23,67.65,72,6.94,17,27,38.64
533,Anthony Duclair,"CBJ, OTT",L,61,770.25,13,10,3,7,23,60.53,102,12.75,2,13,13.33
542,Andre Burakovsky,WSH,L,62,690.7,11,12,7,5,23,71.88,83,13.25,7,13,35
578,Alexander Wennberg,CBJ,C,63,976.9166667,2,21,13,8,23,51.11,55,3.64,311,342,47.63
706,Anthony Beauvillier,NYI,"C, L",67,995.25,16,7,2,5,23,51.11,135,11.85,22,28,44
44,Loui Eriksson,VAN,L,69,973.85,10,12,7,5,22,68.75,92,10.87,2,4,33.33
70,Alexander Edler,VAN,D,43,1016.933333,7,15,8,7,22,44,98,7.14,0,0,-
112,Leo Komarov,NYI,"C, R",68,959.7333333,6,16,9,7,22,56.41,66,9.09,53,69,43.44
156,Kyle Turris,NSH,C,45,706.25,7,15,13,2,22,70.97,62,11.29,237,226,51.19
255,Dmitry Orlov,WSH,D,68,1483.866667,3,19,7,12,22,35.48,83,3.61,0,0,-
398,Matt Nieto,COL,L,58,792.65,4,18,12,6,22,61.11,81,4.94,9,7,56.25
443,Matt Dumba,MIN,D,32,748.0333333,12,10,5,5,22,48.89,93,12.9,0,0,-
455,Cody Ceci,OTT,D,64,1451,5,17,12,5,22,37.29,109,4.59,0,0,-
465,Colton Parayko,STL,D,68,1547.133333,10,12,5,7,22,32.84,159,6.29,0,0,-
532,Mattias Janmark,DAL,C,68,1037.05,6,16,12,4,22,81.48,90,6.67,8,14,36.36
546,Ryan Hartman,"NSH, PHI",R,70,937.1333333,11,11,4,7,22,51.16,123,8.94,4,12,25
565,Brett Pesce,CAR,D,59,1175.116667,6,16,10,6,22,36.07,78,7.69,0,0,-
608,Jake Virtanen,VAN,R,59,875.5,12,10,8,2,22,61.11,140,8.57,5,10,33.33
682,Jordan Greenway,MIN,L,68,906.2333333,11,11,7,4,22,64.71,94,11.7,30,44,40.54
711,Mathieu Joseph,T.B,R,58,660.3166667,13,9,7,2,22,70.97,82,15.85,7,23,23.33
712,Lawson Crouse,ARI,L,67,855.0666667,11,11,8,3,22,64.71,106,10.38,18,27,40
761,Charlie McAvoy,BOS,D,41,895.0166667,5,17,10,7,22,40.74,54,9.26,0,0,-
800,Michal Kempny,WSH,D,65,1261.066667,6,16,6,10,22,30.14,101,5.94,0,0,-
49,Brad Richardson,ARI,C,52,824.3833333,16,5,4,1,21,63.64,101,15.84,445,372,54.47
122,Derick Brassard,"COL, FLA, PIT",C,57,858.45,12,9,4,5,21,61.76,93,12.9,239,258,48.09
258,Brian Dumoulin,PIT,D,65,1354.883333,2,19,3,16,21,27.63,81,2.47,0,0,-
382,Josh Leivo,"TOR, VAN",L,64,846.7666667,13,8,6,2,21,48.84,122,10.66,15,24,38.46
466,Brendan Leipsic,"L.A, VAN",L,58,802.5333333,6,15,10,5,21,65.63,88,6.82,7,6,53.85
477,Jordan Martinook,CAR,L,68,1003.033333,15,6,5,1,21,47.73,123,12.2,145,178,44.89
484,Brock McGinn,CAR,L,68,1000.283333,8,13,7,6,21,53.85,106,7.55,26,26,50
537,Miles Wood,N.J,L,56,760.3833333,8,13,10,3,21,63.64,140,5.71,0,1,0
817,Casey Mittelstadt,BUF,C,64,861,10,11,4,7,21,52.5,96,10.42,178,269,39.82
830,Filip Chytil,NYR,C,64,886.05,10,11,8,3,21,60,110,9.09,34,66,34
836,Neal Pionk,NYR,D,59,1286.216667,5,16,11,5,21,33.87,114,4.39,0,1,0
6,Ron Hainsey,TOR,D,68,1365,5,15,4,11,20,24.39,61,8.2,1,0,100
9,Niklas Kronwall,DET,D,65,1295.233333,3,17,10,7,20,33.33,70,4.29,0,0,-
24,Alexander Steen,STL,L,51,835.6166667,7,13,6,7,20,57.14,84,8.33,6,18,25
103,Andy Greene,N.J,D,69,1449.633333,4,16,9,7,20,33.33,89,4.49,0,0,-
109,Erik Johnson,COL,D,67,1470.7,5,15,5,10,20,28.57,133,3.76,0,0,-
117,Cal Clutterbuck,NYI,R,59,802.6833333,8,12,7,5,20,62.5,74,10.81,13,15,46.43
188,Colin Wilson,COL,C,52,675.9,10,10,2,8,20,60.61,79,12.66,20,28,41.67
246,Zack Kassian,EDM,R,65,903.9,12,8,6,2,20,51.28,92,13.04,0,5,0
342,Jesper Fast,NYR,R,62,975.95,8,12,4,8,20,54.05,78,10.26,7,13,35
437,Luke Glendening,DET,C,68,1069.8,9,11,7,4,20,50,91,9.89,594,467,55.98
447,Brady Skjei,NYR,D,64,1345.333333,6,14,8,6,20,33.33,96,6.25,0,0,-
504,Ben Hutton,VAN,D,64,1443.683333,5,15,5,10,20,37.74,104,4.81,0,0,-
539,Andrew Copp,WPG,C,54,655.0666667,9,11,6,5,20,64.52,64,14.06,127,120,51.42
596,Jordan Oesterle,ARI,D,58,1095.633333,6,14,6,8,20,37.04,62,9.68,0,0,-
635,Marcus Pettersson,"ANA, PIT",D,70,1130.15,2,18,11,7,20,37.74,65,3.08,1,0,100
662,Ondrej Kase,ANA,R,30,469.7333333,11,9,5,4,20,74.07,95,11.58,9,18,33.33
777,Tyson Jost,COL,C,57,745.05,9,11,4,7,20,55.56,85,10.59,37,68,35.24
783,Samuel Girard,COL,D,69,1383.516667,4,16,10,6,20,26.32,105,3.81,0,0,-
147,Pat Maroon,STL,L,60,856.3833333,5,14,7,7,19,41.3,99,5.05,2,2,50
313,Nick Bjugstad,"FLA, PIT",C,50,731.8166667,9,10,2,8,19,55.88,103,8.74,189,186,50.4
365,Josh Archibald,ARI,R,54,737.0666667,10,9,5,4,19,65.52,75,13.33,12,24,33.33
366,Travis Boyd,WSH,C,42,426.9,4,15,9,6,19,76,28,14.29,74,127,36.82
396,Markus Granlund,VAN,C,64,969.05,9,10,6,4,19,63.33,101,8.91,136,178,43.31
420,Oscar Klefbom,EDM,D,47,1162.65,5,14,4,10,19,35.19,136,3.68,0,0,-
634,Ivan Barbashev,STL,C,66,748.7833333,9,10,7,3,19,86.36,43,20.93,155,177,46.69
703,Jack Roslovic,WPG,C,66,645.4666667,7,12,8,4,19,67.86,56,12.5,88,116,43.14
769,Jakob Chychrun,ARI,D,46,938.05,5,14,5,9,19,45.24,100,5,0,0,-
795,Troy Stecher,VAN,D,65,1266.183333,1,18,10,8,19,36.54,86,1.16,0,0,-
31,Braydon Coburn,T.B,D,61,985.3333333,3,15,5,10,18,40.91,93,3.23,0,0,-
89,Justin Abdelkader,DET,L,68,1047.483333,5,13,6,7,18,58.06,90,5.56,51,50,50.5
225,Jordie Benn,MTL,D,68,1245.6,4,14,5,9,18,30,79,5.06,0,0,-
274,Ben Chiarot,WPG,D,63,1163.983333,5,13,8,5,18,43.9,87,5.75,0,0,-
285,Brenden Dillon,S.J,D,68,1180.55,1,17,9,8,18,28.13,60,1.67,0,0,-
376,Adam Lowry,WPG,C,63,930.6166667,9,9,5,4,18,58.06,83,10.84,552,410,57.38
389,Scott Mayfield,NYI,D,65,1212.983333,4,14,4,10,18,34.62,81,4.94,0,0,-
548,Adam Erne,T.B,L,53,558.8166667,7,11,4,7,18,64.29,58,12.07,9,5,64.29
639,Ryan Donato,"BOS, MIN",C,43,566.8166667,8,10,5,5,18,52.94,98,8.16,9,14,39.13
708,Daniel Sprong,"ANA, PIT",R,51,617.9333333,10,8,5,3,18,75,98,10.2,3,10,23.08
798,Drake Caggiula,"CHI, EDM","C, L",50,711.5166667,11,7,3,4,18,52.94,89,12.36,16,25,39.02
1,Matt Cullen,PIT,C,57,653.9833333,5,12,8,4,17,60.71,78,6.41,253,264,48.94
23,Johnny Boychuk,NYI,D,67,1266.483333,3,14,8,6,17,33.33,149,2.01,0,0,-
99,Ryan Reaves,VGK,R,68,738.05,8,9,6,3,17,54.84,81,9.88,40,53,43.01
100,Anton Stralman,T.B,D,45,922.2166667,2,15,5,10,17,36.17,57,3.51,0,0,-
115,Milan Lucic,EDM,L,67,893.4,5,12,9,3,17,48.57,64,7.81,20,18,52.63
120,Jordan Staal,CAR,C,36,677.4333333,6,11,5,6,17,68,91,6.59,422,335,55.75
186,Zach Bogosian,BUF,D,60,1307.25,3,14,5,9,17,31.48,88,3.41,0,0,-
197,Tyler Ennis,TOR,"C, L",42,425.7333333,12,5,4,1,17,89.47,72,16.67,1,0,100
261,Marcus Foligno,MIN,L,69,820.5833333,6,11,6,5,17,65.38,74,8.11,10,13,43.48
262,Sami Vatanen,N.J,D,49,1066.75,4,13,9,4,17,36.96,106,3.77,0,0,-
281,Nic Dowd,WSH,C,52,539.1166667,6,11,8,3,17,77.27,35,17.14,196,187,51.17
321,Chris Wagner,BOS,R,65,859.3333333,11,6,4,2,17,65.38,121,9.09,50,52,49.02
373,Sean Kuraly,BOS,C,65,895.5666667,6,11,7,4,17,73.91,122,4.92,260,226,53.5
402,Scott Harrington,CBJ,D,62,791.7333333,2,15,6,9,17,51.52,47,4.26,0,0,-
407,Adam Larsson,EDM,D,68,1499.333333,3,14,6,8,17,34.69,99,3.03,0,0,-
413,Jonas Brodin,MIN,D,69,1418.066667,4,13,5,8,17,37.78,87,4.6,0,0,-
418,Joel Armia,MTL,R,44,715.3166667,10,7,4,3,17,51.52,113,8.85,5,24,17.24
545,Jason Dickinson,DAL,C,53,694.0166667,5,12,6,6,17,73.91,70,7.14,177,223,44.25
610,William Nylander,TOR,R,40,599.0833333,5,12,7,5,17,56.67,83,6.02,137,119,53.52
676,Pavel Zacha,N.J,C,53,835.8666667,11,6,2,4,17,45.95,86,12.79,308,315,49.44
680,Travis Dermott,TOR,D,60,1037.8,4,13,5,8,17,38.64,92,4.35,0,0,-
808,Zach Aston-Reese,PIT,C,42,578.8166667,8,9,3,6,17,65.38,76,10.53,8,10,44.44
835,David Kampf,CHI,C,52,749.0833333,4,13,8,5,17,68,65,6.15,229,281,44.9
73,Troy Brouwer,FLA,R,61,760.2833333,9,7,6,1,16,66.67,72,12.5,16,28,36.36
203,Travis Hamonic,CGY,D,57,1192.9,7,9,5,4,16,25.81,105,6.67,0,1,0
279,Nick Jensen,"DET, WSH",D,66,1350.85,2,14,5,9,16,30.77,83,2.41,0,0,-
316,Cam Fowler,ANA,D,46,1079.366667,4,12,6,6,16,35.56,74,5.41,0,0,-
340,Kenny Agostino,"MTL, N.J",L,50,597.9666667,3,13,7,6,16,61.54,59,5.08,10,25,28.57
448,Tanner Pearson,"L.A, PIT, VAN",L,67,903.95,10,6,5,1,16,64,113,8.85,5,10,33.33
464,Matt Grzelcyk,BOS,D,60,1161.016667,2,14,7,7,16,30.77,84,2.38,0,0,-
473,Jujhar Khaira,EDM,L,55,687.6,3,13,10,3,16,66.67,57,5.26,50,68,42.37
515,Carter Rowney,ANA,"C, R",49,600.4833333,5,11,6,5,16,88.89,42,11.9,162,168,49.09
517,Michael Raffl,PHI,L,54,628.1666667,5,11,6,5,16,57.14,53,9.43,13,20,39.39
554,Robert Hagg,PHI,D,68,1177.016667,4,12,8,4,16,32.65,76,5.26,0,0,-
692,Christian Fischer,ARI,R,64,846.1833333,11,5,2,3,16,55.17,104,10.58,2,5,28.57
702,Austin Wagner,L.A,L,49,425.0166667,9,7,5,2,16,94.12,51,17.65,2,2,50
743,Markus Nutivaara,CBJ,D,67,1145.966667,4,12,7,5,16,33.33,80,5,0,0,-
772,Brett Howden,NYR,C,52,774.15,4,12,8,4,16,51.61,57,7.02,294,288,50.52
782,Dennis Cholowski,DET,D,52,949.1666667,7,9,4,5,16,35.56,71,9.86,1,0,100
793,Filip Hronek,DET,D,32,621.4833333,3,13,6,7,16,57.14,51,5.88,0,0,-
47,David Backes,BOS,R,56,735.0833333,5,10,3,7,15,46.88,101,4.95,171,128,57.19
71,Ryan Callahan,T.B,R,46,518.7833333,6,9,7,2,15,62.5,66,9.09,6,15,28.57
87,James Neal,CGY,L,55,826.1833333,5,10,6,4,15,50,122,4.1,5,6,45.45
88,Marc-Edouard Vlasic,S.J,D,58,1231.466667,1,14,7,7,15,26.79,76,1.32,0,0,-
102,Dan Girardi,T.B,D,61,1083.883333,4,11,1,10,15,29.41,75,5.33,0,0,-
173,Alec Martinez,L.A,D,46,971.8666667,4,11,5,6,15,39.47,58,6.9,0,0,-
256,Brandon Pirri,VGK,C,26,378.9333333,10,5,3,2,15,62.5,70,14.29,14,18,43.75
266,David Savard,CBJ,D,68,1317.95,4,11,6,5,15,25.42,100,4,0,0,-
287,Radko Gudas,PHI,D,64,1148.583333,2,13,5,8,15,33.33,113,1.77,0,0,-
293,Oscar Lindberg,"OTT, VGK","C, L",42,499.95,7,8,6,2,15,62.5,75,9.33,40,46,46.51
320,Riley Sheahan,"FLA, PIT",C,68,906.8166667,8,7,3,4,15,55.56,88,9.09,262,257,50.48
367,Dylan DeMelo,OTT,D,64,1202.566667,3,12,6,6,15,20.83,93,3.23,0,0,-
474,Adam Pelech,NYI,D,64,1162.1,4,11,5,6,15,30.61,84,4.76,0,0,-
513,Danny DeKeyser,DET,D,41,883.05,4,11,9,2,15,41.67,48,8.33,0,0,-
594,Ryan Carpenter,VGK,C,55,696.1666667,5,10,5,5,15,55.56,81,6.17,130,121,51.79
600,Melker Karlsson,S.J,C,68,775.6,11,4,1,3,15,60,71,15.49,14,9,60.87
602,Tomas Nosek,VGK,L,57,708.7666667,7,8,6,2,15,65.22,97,7.22,59,31,65.56
735,Conor Garland,ARI,R,39,494.2666667,12,3,0,3,15,62.5,101,11.88,10,6,62.5
759,Maxime Lajoie,OTT,D,56,1058.716667,7,8,3,5,15,42.86,79,8.86,0,0,-
815,Michael Rasmussen,DET,C,56,688.6,7,8,6,2,15,50,66,10.61,17,35,32.69
37,Eric Fehr,MIN,C,59,642.4833333,7,7,3,4,14,77.78,57,12.28,289,261,52.55
64,Blake Comeau,DAL,L,64,1000.766667,6,8,3,5,14,53.85,73,8.22,22,28,44
85,Andrew Cogliano,"ANA, DAL","C, L",65,834.65,4,10,8,2,14,66.67,90,4.44,9,16,36
92,Kris Russell,EDM,D,58,1186.2,2,12,4,8,14,31.11,52,3.85,0,0,-
98,Darren Helm,DET,L,47,673.4,6,8,7,1,14,66.67,83,7.23,13,16,44.83
145,Justin Braun,S.J,D,64,1303.1,1,13,6,7,14,33.33,88,1.14,0,0,-
160,Colton Sceviour,FLA,C,49,604,5,9,7,2,14,63.64,101,4.95,36,62,36.73
245,Calvin de Haan,CAR,D,66,1243.033333,1,13,7,6,14,30.43,96,1.04,0,1,0
251,Brayden McNabb,VGK,D,69,1348.95,3,11,7,4,14,23.33,65,4.62,0,0,-
363,Josh Manson,ANA,D,65,1455.633333,3,11,9,2,14,29.79,85,3.53,0,0,-
431,Barclay Goodrow,S.J,R,68,739.0666667,5,9,3,6,14,46.67,69,7.25,235,194,54.78
454,Zemgus Girgensons,BUF,C,61,831.5833333,3,11,5,6,14,70,66,4.55,25,32,43.86
483,Jake McCabe,BUF,D,55,1036.333333,4,10,3,7,14,37.84,59,6.78,0,1,0
494,Cedric Paquette,T.B,C,68,813.95,10,4,3,1,14,50,69,14.49,338,308,52.32
521,Tyler Motte,VAN,C,67,863.2333333,7,7,4,3,14,58.33,101,6.93,15,30,33.33
564,Zach Sanford,STL,L,47,610,7,7,4,3,14,58.33,66,10.61,8,5,61.54
632,Brendan Lemieux,"NYR, WPG",L,50,400.35,10,4,1,3,14,66.67,53,18.87,4,11,26.67
732,Denis Malgin,FLA,C,46,592.0833333,7,7,4,3,14,70,60,11.67,34,51,40
757,Luke Kunin,MIN,C,37,558.1333333,5,9,6,3,14,56,59,8.47,43,49,46.74
786,Henrik Borgstrom,FLA,C,37,464.7833333,8,6,1,5,14,63.64,47,17.02,131,185,41.46
22,Jay Bouwmeester,STL,D,64,1307.783333,2,11,7,4,13,37.14,67,2.99,0,0,-
80,Jack Johnson,PIT,D,68,1327.75,1,12,5,7,13,23.21,68,1.47,0,0,-
82,Marc Staal,NYR,D,67,1309.516667,3,10,3,7,13,26.53,72,4.17,0,0,-
106,Alex Biega,VAN,D,30,486.5166667,2,11,6,5,13,54.17,68,2.94,0,0,-
123,Michael Grabner,ARI,R,27,384.1,8,5,5,0,13,76.47,48,16.67,4,6,40
177,Nick Holden,VGK,D,53,963.9333333,3,10,5,5,13,30.95,60,5,0,0,-
217,Matt Martin,NYI,L,53,599.9666667,5,8,3,5,13,61.9,47,10.64,6,7,46.15
233,Kyle Clifford,L.A,L,58,568.9666667,7,6,3,3,13,68.42,87,8.05,3,4,42.86
307,Jon Merrill,VGK,D,46,811.9666667,3,10,4,6,13,34.21,62,4.84,0,0,-
318,Austin Watson,NSH,L,34,492.3666667,7,6,4,2,13,56.52,59,11.86,7,9,43.75
388,Rocco Grimaldi,NSH,C,48,484.3833333,5,8,4,4,13,92.86,76,6.58,3,3,50
415,Sven Baertschi,VAN,L,22,343.8666667,8,5,3,2,13,68.42,40,20,1,3,25
451,Olli Maatta,PIT,D,55,1019.65,1,12,6,6,13,25.49,65,1.54,0,0,-
593,Trevor van Riemsdyk,CAR,D,64,963.1833333,2,11,5,6,13,40.63,84,2.38,0,0,-
601,Pierre-Edouard Bellemare,VGK,"C, L",68,841.8,5,8,6,2,13,44.83,93,5.38,350,302,53.68
614,Brendan Perlini,"ARI, CHI",L,55,631.5833333,8,5,3,2,13,61.9,88,9.09,1,6,14.29
649,Devon Toews,NYI,D,34,605.2833333,5,8,5,3,13,48.15,52,9.62,0,0,-
672,Rasmus Andersson,CGY,D,65,1011.066667,2,11,4,7,13,26.53,90,2.22,0,0,-
717,Joel Eriksson Ek,MIN,C,52,694.2166667,6,7,7,0,13,54.17,97,6.19,213,255,45.51
741,Brett Seney,N.J,L,50,517.2166667,5,8,5,3,13,76.47,49,10.2,97,161,37.6
66,Brandon Dubinsky,CBJ,C,47,582.7666667,5,7,4,3,12,70.59,46,10.87,332,257,56.37
94,Vladimir Sobotka,BUF,C,62,889.1833333,5,7,3,4,12,52.17,68,7.35,294,265,52.59
243,Magnus Paajarvi,OTT,L,67,898.7666667,7,5,0,5,12,63.16,99,7.07,6,7,46.15
290,Christopher Tanev,VAN,D,53,1087.083333,2,10,6,4,12,31.58,51,3.92,0,0,-
303,Jordan Weal,"ARI, MTL, PHI",C,50,646.2,5,7,4,3,12,57.14,55,9.09,268,208,56.3
314,Derek Forbort,L.A,D,67,1402.75,1,11,3,8,12,32.43,59,1.69,0,1,0
459,Derrick Pouliot,VAN,D,61,1048.033333,3,9,4,5,12,24.49,57,5.26,0,0,-
534,Sven Andrighetto,COL,R,51,577.4333333,4,8,5,3,12,54.55,74,5.41,2,8,20
584,Frederik Gauthier,TOR,C,58,484.3666667,3,9,4,5,12,57.14,40,7.5,198,163,54.85
642,Warren Foegele,CAR,L,66,851.65,7,5,3,2,12,54.55,91,7.69,10,11,47.62
685,Erik Cernak,T.B,D,45,846.9666667,3,9,5,4,12,25,75,4,0,0,-
740,Adam Gaudette,VAN,C,43,445.9333333,5,7,4,3,12,63.16,43,11.63,116,155,42.8
792,Tage Thompson,BUF,"C, R",58,705.9333333,7,5,5,0,12,66.67,99,7.07,9,9,50
826,Henri Jokiharju,CHI,D,38,721.25,0,12,7,5,12,33.33,62,0,0,0,-
860,Par Lindholm,"TOR, WPG",C,63,718,1,11,6,5,12,50,63,1.59,204,203,50.12
143,Ian Cole,COL,D,58,1171.233333,1,10,2,8,11,22.45,69,1.45,0,0,-
201,Justin Schultz,PIT,D,15,303.3333333,1,10,3,7,11,47.83,19,5.26,0,0,-
205,Marco Scandella,BUF,D,54,961.65,4,7,1,6,11,32.35,76,5.26,0,0,-
210,Dale Weise,"MTL, PHI",R,51,600.6166667,5,6,3,3,11,73.33,58,8.62,6,10,37.5
213,Derek Grant,"ANA, PIT",C,43,480.3333333,4,7,5,2,11,57.89,58,6.9,180,161,52.79
301,Greg McKegg,CAR,C,28,317.7,6,5,4,1,11,84.62,25,24,102,99,50.75
369,Tobias Rieder,EDM,R,54,693.2333333,0,11,7,4,11,84.62,75,0,4,16,20
385,Mike Reilly,MTL,D,57,1064.516667,3,8,2,6,11,23.4,101,2.97,0,0,-
387,Ty Rattie,EDM,R,45,510.8333333,4,7,6,1,11,50,79,5.06,1,2,33.33
397,Joel Edmundson,STL,D,61,1198.466667,2,9,8,1,11,22.92,100,2,0,1,0
416,Jamie Oleksiak,"DAL, PIT",D,51,758.5333333,4,7,2,5,11,31.43,51,7.84,0,0,-
432,Brad Hunt,"MIN, VGK",D,29,409.6833333,5,6,3,3,11,50,54,9.26,0,0,-
499,Matthew Benning,EDM,D,56,812.3,2,9,3,6,11,25.58,71,2.82,0,0,-
520,MacKenzie Weegar,FLA,D,50,831.95,3,8,4,4,11,36.67,63,4.76,1,0,100
580,Nikita Zadorov,COL,D,57,970.7833333,7,4,3,1,11,26.83,79,8.86,0,0,-
699,Roope Hintz,DAL,L,44,580.7333333,5,6,4,2,11,61.11,64,7.81,147,134,52.31
722,Austin Czarnik,CGY,C,40,428.6333333,6,5,5,0,11,73.33,51,11.76,17,23,42.5
779,Victor Mete,MTL,D,58,1014.266667,0,11,3,8,11,23.91,53,0,0,0,-
804,Matt Luff,L.A,R,33,366.8333333,8,3,2,1,11,68.75,45,17.78,1,3,25
2,Zdeno Chara,BOS,D,49,1028.933333,4,6,1,5,10,23.26,71,5.63,0,0,-
58,Andrew Ladd,NYI,L,18,248.4166667,3,7,3,4,10,83.33,25,12,2,3,40
97,Niklas Hjalmarsson,ARI,D,68,1344.583333,0,10,2,8,10,17.86,47,0,0,0,-
174,Carl Hagelin,"L.A, PIT, WSH",L,45,656.1666667,3,7,4,3,10,38.46,79,3.8,4,19,17.39
250,John Moore,BOS,D,53,1008.883333,3,7,4,3,10,30.3,90,3.33,0,0,-
278,Marcus Kruger,CHI,C,61,647.35,4,6,4,2,10,50,57,7.02,166,184,47.43
299,Johan Larsson,BUF,C,59,848.1333333,5,5,3,2,10,45.45,62,8.06,404,401,50.19
308,Tyler Pitlick,DAL,C,43,588.4166667,6,4,3,1,10,50,68,8.82,5,7,41.67
329,Mark Pysyk,FLA,D,57,1062.866667,1,9,4,5,10,21.74,55,1.82,0,0,-
352,Taylor Fedun,DAL,D,43,603.4666667,3,7,5,2,10,52.63,69,4.35,0,0,-
356,Brian Gibbons,"ANA, OTT","C, L",51,537.4333333,4,6,5,1,10,55.56,41,9.76,3,8,27.27
358,Matthew Peca,MTL,C,38,399.6166667,3,7,5,2,10,125,35,8.57,80,89,47.34
419,Nathan Beaulieu,"BUF, WPG",D,35,531.55,3,7,3,4,10,37.04,43,6.98,0,0,-
421,Connor Murphy,CHI,D,38,744.1,3,7,2,5,10,23.81,62,4.84,0,0,-
469,Chandler Stephenson,WSH,C,55,680.3833333,5,5,4,1,10,71.43,32,15.63,36,39,48
492,Brett Kulak,MTL,D,44,755.4333333,3,7,2,5,10,25,73,4.11,0,0,-
581,Mirco Mueller,N.J,D,47,853.1833333,1,9,5,4,10,34.48,36,2.78,0,0,-
598,Garnet Hathaway,CGY,R,62,630.6166667,7,3,1,2,10,47.62,61,11.48,4,4,50
739,Troy Terry,ANA,R,22,304.9666667,4,6,5,1,10,55.56,19,21.05,1,3,25
742,Mason Appleton,WPG,C,36,295.35,3,7,5,2,10,58.82,29,10.34,0,1,0
797,Nikita Zaitsev,TOR,D,68,1384.933333,3,7,2,5,10,17.86,58,5.17,0,0,-
844,Kiefer Sherwood,ANA,R,46,516.8333333,5,5,0,5,10,58.82,51,9.8,7,6,53.85
849,Lukas Radil,S.J,C,32,342.2166667,6,4,3,1,10,58.82,37,16.22,5,3,62.5
11,Deryk Engelland,VGK,D,62,1236,2,7,5,2,9,24.32,83,2.41,0,0,-
129,Andrew MacDonald,PHI,D,44,734.05,0,9,3,6,9,28.13,38,0,0,0,-
135,Ben Lovejoy,"DAL, N.J",D,58,1003.783333,2,7,3,4,9,25.71,75,2.67,0,0,-
158,Brendan Smith,NYR,D,50,780.2333333,2,7,5,2,9,47.37,46,4.35,0,1,0
166,Robert Bortuzzo,STL,D,45,693.0333333,2,7,5,2,9,33.33,55,3.64,0,0,-
181,Jay Beagle,VAN,C,45,609.4333333,3,6,3,3,9,60,37,8.11,315,265,54.31
324,Erik Gudbranson,"PIT, VAN",D,62,1125.683333,2,7,3,4,9,23.68,80,2.5,0,0,-
336,Tom Kuhnhackl,NYI,R,29,380.15,4,5,4,1,9,52.94,26,15.38,0,2,0
338,Tim Heed,S.J,D,24,330.5,2,7,4,3,9,42.86,27,7.41,0,0,-
478,Boo Nieves,NYR,C,34,316.8,4,5,2,3,9,81.82,23,17.39,78,120,39.39
562,William Carrier,VGK,L,48,470.85,8,1,1,0,9,64.29,81,9.88,0,0,-
686,Jakob Forsbacka Karlsson,BOS,C,28,330.2166667,3,6,3,3,9,81.82,21,14.29,95,131,42.04
737,Christian Jaros,OTT,D,50,707.5,1,8,2,6,9,39.13,55,1.82,0,0,-
768,Jesse Puljujarvi,EDM,R,46,549.85,4,5,3,2,9,56.25,53,7.55,2,2,50
838,Radim Simek,S.J,D,39,602.6833333,1,8,3,5,9,29.03,38,2.63,0,0,-
841,Drake Batherson,OTT,R,20,268.3,3,6,3,3,9,69.23,18,16.67,3,1,75
7,Brooks Orpik,WSH,D,40,628.7166667,2,6,1,5,8,26.67,31,6.45,0,0,-
40,Ryan Kesler,ANA,C,60,989.9166667,5,3,3,0,8,36.36,86,5.81,582,463,55.69
51,Nate Thompson,"L.A, MTL",C,66,855.4166667,4,4,1,3,8,36.36,51,7.84,353,300,54.06
53,Kyle Brodziak,EDM,C,62,740.5666667,5,3,2,1,8,50,66,7.58,363,334,52.08
60,Drew Stafford,N.J,R,44,508.1666667,2,6,4,2,8,53.33,59,3.39,11,19,36.67
150,Sam Gagner,"EDM, VAN",C,18,283.8833333,4,4,3,1,8,61.54,41,9.76,27,35,43.55
154,Riley Nash,CBJ,C,65,671.6333333,1,7,5,2,8,50,64,1.56,135,166,44.85
163,Mario Kempe,ARI,R,45,509.5333333,3,5,3,2,8,47.06,48,6.25,99,176,36
164,Yannick Weber,NSH,D,54,656.05,2,6,3,3,8,30.77,62,3.23,0,0,-
269,Kevin Connauton,ARI,D,45,839.25,1,7,3,4,8,24.24,69,1.45,0,0,-
298,Ryan Spooner,"EDM, NYR, VAN",C,47,519.8,3,5,3,2,8,61.54,60,5,54,51,51.43
306,Patrik Nemeth,COL,D,61,1025.866667,1,7,5,2,8,22.22,44,2.27,0,0,-
312,Devante Smith-Pelly,WSH,R,54,586.1166667,4,4,3,1,8,57.14,60,6.67,16,25,39.02
332,Joakim Nordstrom,BOS,C,56,775.2,5,3,2,1,8,50,89,5.62,47,70,40.17
384,Jean-Gabriel Pageau,OTT,C,27,464.6333333,3,5,4,1,8,61.54,65,4.62,172,127,57.53
392,Dmitrij Jaskin,WSH,R,36,363.5833333,2,6,1,5,8,61.54,47,4.26,0,3,0
393,Victor Rask,"CAR, MIN",C,36,434.5333333,2,6,3,3,8,53.33,37,5.41,148,174,45.96
523,Saku Maenalanen,CAR,R,29,280.2333333,4,4,3,1,8,61.54,31,12.9,6,14,30
549,Jacob de la Rose,DET,"C, L",55,635.2,3,5,2,3,8,47.06,54,5.56,148,200,42.53
645,Michael Amadio,L.A,C,37,375.3833333,4,4,1,3,8,44.44,28,14.29,71,110,39.23
653,Gustav Forsling,CHI,D,30,524.35,3,5,1,4,8,47.06,40,7.5,0,0,-
729,Noel Acciari,BOS,C,59,766.2166667,3,5,2,3,8,53.33,78,3.85,145,137,51.42
866,Bogdan Kiselevich,FLA,D,32,475.3333333,0,8,6,2,8,57.14,14,0,0,0,-
867,Antti Suomela,S.J,C,27,305.5666667,3,5,3,2,8,100,42,7.14,102,127,44.54
20,Trevor Daley,DET,D,41,757.9,2,5,4,1,7,23.33,44,4.55,0,0,-
27,Chris Kunitz,CHI,L,43,396.1666667,2,5,3,2,7,70,34,5.88,2,5,28.57
72,Roman Polak,DAL,D,65,1248.25,1,6,3,3,7,18.92,67,1.49,0,0,-
162,Carl Gunnarsson,STL,D,18,293.7,3,4,0,4,7,31.82,18,16.67,0,0,-
195,Michael Del Zotto,"ANA, STL, VAN",D,36,637.75,1,6,1,5,7,28,42,2.38,0,0,-
264,Chris Wideman,"EDM, FLA, OTT",D,25,326.4333333,2,5,3,2,7,43.75,27,7.41,0,0,-
275,Erik Haula,VGK,"C, L",15,248.8166667,2,5,3,2,7,77.78,26,7.69,78,74,51.32
277,Phil Varone,PHI,C,37,293.8166667,3,4,3,1,7,70,24,12.5,70,72,49.3
400,Miikka Salomaki,NSH,R,37,386.8666667,3,4,1,3,7,50,51,5.88,2,5,28.57
422,Stefan Noesen,N.J,R,29,355.45,2,5,3,2,7,58.33,37,5.41,20,28,41.67
507,Christian Djoos,WSH,D,36,469.5,1,6,4,2,7,31.82,26,3.85,0,0,-
560,Madison Bowey,"DET, WSH",D,37,514.75,1,6,2,4,7,36.84,40,2.5,0,0,-
575,Valeri Nichushkin,DAL,R,48,587.5,0,7,2,5,7,36.84,57,0,3,3,50
587,Colby Cave,"BOS, EDM",C,39,472.5833333,2,5,2,3,7,53.85,44,4.55,142,152,48.3
633,Jayce Hawryluk,FLA,C,32,284.5333333,4,3,2,1,7,63.64,25,16,9,1,90
648,Christoffer Ehn,DET,C,46,454.7666667,2,5,1,4,7,63.64,34,5.88,51,56,47.66
691,Oliver Kylington,CGY,D,36,440.45,3,4,1,3,7,58.33,18,16.67,0,0,-
696,Brandon Carlo,BOS,D,59,1227.766667,1,6,4,2,7,17.95,94,1.06,0,0,-
724,Markus Hannikainen,CBJ,L,43,405.6666667,4,3,2,1,7,70,50,8,0,3,0
734,Christian Wolanin,OTT,D,18,285.6833333,3,4,0,4,7,36.84,21,14.29,0,0,-
738,Rudolfs Balcers,OTT,L,24,275.15,4,3,1,2,7,87.5,33,12.12,1,1,50
806,Trevor Moore,TOR,L,13,116.35,1,6,2,4,7,87.5,9,11.11,0,0,-
825,Max Comtois,ANA,L,10,145.9,2,5,3,2,7,87.5,9,22.22,3,8,27.27
843,Sean Walker,L.A,D,30,454.3833333,2,5,3,2,7,36.84,42,4.76,0,0,-
859,Igor Ozhiganov,TOR,D,46,659.7166667,3,4,2,2,7,26.92,36,8.33,0,0,-
42,Corey Perry,ANA,R,18,284.8666667,3,3,3,0,6,85.71,37,8.11,0,0,-
111,Trevor Lewis,L.A,C,30,407.3,2,4,2,2,6,60,58,3.45,45,51,46.88
159,Brandon Sutter,VAN,C,26,454.15,4,2,1,1,6,50,43,9.3,224,238,48.48
247,Dmitry Kulikov,WPG,D,42,620.95,0,6,3,3,6,22.22,27,0,0,0,-
270,Garrett Wilson,PIT,L,36,275.6666667,1,5,3,2,6,66.67,34,2.94,1,3,25
273,Gabriel Bourque,COL,L,42,415.9666667,1,5,5,0,6,50,24,4.17,7,9,43.75
354,Kevan Miller,BOS,D,36,646.05,0,6,2,4,6,27.27,32,0,0,0,-
362,Lukas Sedlak,CBJ,C,44,397.55,4,2,1,1,6,50,41,9.76,42,44,48.84
370,Fredrik Claesson,NYR,D,30,519.8333333,2,4,3,1,6,37.5,35,5.71,0,0,-
372,Nick Seeler,MIN,D,62,767.5166667,2,4,1,3,6,25,63,3.17,0,0,-
395,Brett Ritchie,DAL,R,45,442.2666667,4,2,0,2,6,50,46,8.7,2,5,28.57
423,Joe Morrow,WPG,D,39,542.3166667,1,5,3,2,6,21.43,40,2.5,0,0,-
435,J.T. Brown,MIN,R,44,397.25,2,4,2,2,6,42.86,45,4.44,4,11,26.67
485,Connor Carrick,"DAL, N.J",D,21,311.5666667,1,5,2,3,6,85.71,25,4,0,0,-
536,Peter Cehlarik,BOS,L,18,229.4666667,4,2,1,1,6,60,26,15.38,0,5,0
558,Carl Dahlstrom,CHI,D,31,572.5,0,6,2,4,6,18.18,36,0,0,0,-
585,Jean-Sebastien Dea,"N.J, PIT",C,23,235.8833333,4,2,0,2,6,85.71,29,13.79,53,51,50.96
641,Juho Lammikko,FLA,R,40,437.2666667,0,6,5,1,6,66.67,39,0,142,190,42.77
661,Dylan Sikura,CHI,R,22,222.35,0,6,5,1,6,60,30,0,0,3,0
666,Andrew Mangiapane,CGY,L,30,296.4166667,3,3,1,2,6,60,41,7.32,5,2,71.43
700,Caleb Jones,EDM,D,17,336.55,1,5,2,3,6,46.15,21,4.76,0,0,-
753,Kevin Rooney,N.J,C,28,326.9,4,2,1,1,6,60,23,17.39,107,115,48.2
805,Alexandre Fortin,CHI,L,24,254.1833333,3,3,2,1,6,75,29,10.34,11,6,64.71
840,Jan Rutta,"CHI, T.B",D,24,383.9833333,2,4,2,2,6,35.29,24,8.33,0,0,-
842,Sheldon Dries,COL,C,40,362.95,3,3,2,1,6,60,44,6.82,66,65,50.38
858,Lawrence Pilut,BUF,D,25,429.9333333,1,5,3,2,6,33.33,25,4,0,0,-
863,Egor Yakovlev,N.J,D,21,318.45,2,4,2,2,6,54.55,21,9.52,0,0,-
26,Jonathan Ericsson,DET,D,48,849.8,3,2,1,1,5,20,42,7.14,0,0,-
32,Dion Phaneuf,L.A,D,59,879.45,1,4,1,3,5,18.52,69,1.45,0,0,-
90,Adam McQuaid,"CBJ, NYR",D,41,688.9166667,2,3,2,1,5,19.23,20,10,0,0,-
113,Jamie McGinn,FLA,L,10,107.0333333,2,3,3,0,5,83.33,12,16.67,0,0,-
179,Micheal Haley,"FLA, S.J",C,32,248.4666667,1,4,2,2,5,62.5,24,4.17,13,13,50
215,Greg Pateryn,MIN,D,67,1135.883333,0,5,4,1,5,13.16,81,0,0,1,0
289,Matt Irwin,NSH,D,36,415.4833333,1,4,2,2,5,27.78,44,2.27,0,0,-
333,Michael Chaput,MTL,C,32,359.1333333,0,5,3,2,5,50,31,0,124,120,50.82
351,Ben Street,ANA,C,21,253.4166667,3,2,2,0,5,83.33,19,15.79,16,27,37.21
471,Mackenzie MacEachern,STL,L,25,201.9,3,2,1,1,5,83.33,32,9.38,0,0,-
480,Martin Frk,DET,R,25,210.2166667,1,4,3,1,5,62.5,21,4.76,0,0,-
486,Charles Hudon,MTL,L,32,373.5333333,3,2,1,1,5,45.45,50,6,4,5,44.44
508,Joakim Ryan,S.J,D,34,423.4333333,0,5,0,5,5,20,28,0,0,0,-
512,Tim Schaller,VAN,C,36,397.9,0,5,4,1,5,45.45,32,0,1,1,50
529,John Hayden,CHI,R,50,461.2333333,3,2,1,1,5,38.46,38,7.89,6,19,24
541,Ryan Graves,COL,D,21,254.0833333,3,2,1,1,5,35.71,23,13.04,0,0,-
607,Michael Dal Colle,NYI,L,23,272.65,2,3,3,0,5,45.45,23,8.7,0,1,0
623,Robby Fabbri,STL,C,29,371.7166667,2,3,2,1,5,29.41,38,5.26,4,10,28.57
636,Vladislav Kamenev,COL,C,23,207.9,2,3,1,2,5,50,22,9.09,59,59,50
701,Noah Juulsen,MTL,D,21,359.4166667,1,4,0,4,5,26.32,22,4.55,0,0,-
751,Casey Nelson,BUF,D,25,366.7666667,1,4,1,3,5,35.71,22,4.55,0,0,-
770,Dillon Dube,CGY,C,23,227.9833333,1,4,0,4,5,55.56,22,4.55,15,24,38.46
778,Josh Mahura,ANA,D,17,243.1666667,1,4,2,2,5,41.67,20,5,0,0,-
809,Gavin Bayreuther,DAL,D,19,345.5833333,2,3,2,1,5,35.71,25,8,0,0,-
829,Lias Andersson,NYR,C,29,298.8,1,4,2,2,5,71.43,31,3.23,46,62,42.59
861,Juuso Riikola,PIT,D,37,617.3333333,2,3,1,2,5,19.23,43,4.65,0,0,-
15,Dan Hamhuis,NSH,D,53,862.45,0,4,1,3,4,15.38,34,0,0,0,-
121,Patrik Berglund,BUF,C,23,299.9833333,2,2,1,1,4,57.14,25,8,68,48,58.62
155,Thomas Hickey,NYI,D,33,624.75,0,4,2,2,4,14.29,37,0,0,0,-
207,Michael Stone,CGY,D,11,176.3,0,4,2,2,4,57.14,10,0,0,0,-
216,Mark Borowiecki,OTT,D,45,690.2833333,1,3,2,1,4,18.18,49,2.04,0,0,-
284,Brandon Manning,"CHI, EDM",D,39,578.8,2,2,1,1,4,20,33,6.06,0,0,-
294,Martin Marincin,TOR,D,15,225.7166667,0,4,1,3,4,50,22,0,0,1,0
381,Alan Quine,CGY,C,9,85.05,3,1,0,1,4,100,6,50,7,8,46.67
430,Tomas Hyka,VGK,R,17,200.0166667,1,3,1,2,4,36.36,22,4.55,1,1,50
445,Phillip Di Giuseppe,"CAR, NSH",L,24,243.25,1,3,1,2,4,57.14,31,3.23,3,2,60
461,Slater Koekkoek,"CHI, T.B",D,24,368.7833333,1,3,2,1,4,21.05,33,3.03,0,0,-
482,Teddy Blueger,PIT,C,14,130.4833333,3,1,1,0,4,80,15,20,8,9,47.06
498,Paul LaDue,L.A,D,26,340.9,2,2,1,1,4,30.77,25,8,0,0,-
551,Valentin Zykov,"CAR, EDM, VGK",L,24,235.0666667,1,3,1,2,4,57.14,25,4,2,7,22.22
586,Ross Johnston,NYI,L,17,134.55,1,3,2,1,4,57.14,12,8.33,0,1,0
590,Josh Currie,EDM,R,10,99.11666667,2,2,2,0,4,66.67,10,20,1,2,33.33
595,Christian Folin,"MTL, PHI",D,32,500.25,0,4,1,3,4,14.29,30,0,1,0,100
599,Frederick Gaudreau,NSH,C,51,459.45,3,1,1,0,4,30.77,39,7.69,148,162,47.74
616,Julius Honka,DAL,D,29,397.6833333,0,4,4,0,4,23.53,38,0,0,1,0
660,Sammy Blais,STL,L,31,303.4666667,2,2,2,0,4,33.33,24,8.33,1,1,50
665,Dryden Hunt,FLA,L,21,221.6833333,0,4,2,2,4,44.44,36,0,0,3,0
674,Jonas Siegenthaler,WSH,D,25,349.8833333,0,4,2,2,4,28.57,12,0,0,0,-
716,Jacob Larsson,ANA,D,40,650.3,0,4,2,2,4,23.53,45,0,0,0,-
718,Denis Gurianov,DAL,R,21,228.3166667,1,3,1,2,4,66.67,23,4.35,1,1,50
727,Andreas Martinsen,CHI,L,24,190.4333333,1,3,3,0,4,66.67,21,4.76,3,4,42.86
745,Sami Niku,WPG,D,20,272.95,1,3,0,3,4,40,14,7.14,0,0,-
771,Sam Steel,ANA,C,16,231.35,1,3,3,0,4,66.67,21,4.76,81,81,50
864,Ilya Lyubushkin,ARI,D,38,515.1833333,0,4,3,1,4,28.57,26,0,0,0,-
140,Steven Kampfer,BOS,D,25,364.1833333,2,1,0,1,3,33.33,23,8.7,0,0,-
178,Jason Demers,ARI,D,21,408.7333333,1,2,1,1,3,25,23,4.35,0,0,-
206,Jori Lehtera,PHI,C,27,246,1,2,1,1,3,50,17,5.88,79,67,54.11
222,Zac Rinaldo,NSH,"C, L",23,163.8666667,1,2,2,0,3,75,11,9.09,1,4,20
267,Nicolas Deslauriers,MTL,L,45,446.4666667,2,1,1,0,3,37.5,41,4.88,1,0,100
302,Connor Brickley,NYR,L,8,69.66666667,1,2,1,1,3,100,14,7.14,0,4,0
343,Kevin Gravel,EDM,D,35,518.95,0,3,2,1,3,18.75,44,0,0,0,-
344,Anthony Bitetto,"MIN, NSH",D,31,361.75,0,3,1,2,3,25,27,0,0,0,-
399,Xavier Ouellet,MTL,D,19,323.2166667,0,3,1,2,3,37.5,32,0,0,0,-
429,Kurtis Gabriel,N.J,R,17,118.0666667,2,1,1,0,3,60,5,40,0,0,-
446,Brendan Gaunce,VAN,C,3,22.83333333,1,2,1,1,3,75,2,50,8,5,61.54
491,Gemel Smith,"BOS, DAL",C,17,142.25,2,1,1,0,3,75,14,14.29,2,2,50
506,Jaycob Megna,ANA,D,16,223.8333333,1,2,1,1,3,42.86,21,4.76,0,0,-
540,Ben Harpur,OTT,D,42,728.25,1,2,1,1,3,13.04,39,2.56,0,0,-
555,Steven Santini,N.J,D,26,408.7333333,1,2,0,2,3,25,25,4,0,0,-
556,Nic Petan,"TOR, WPG","C, L",15,111.5666667,1,2,1,1,3,75,12,8.33,10,5,66.67
640,Christian Dvorak,ARI,C,6,89.25,2,1,1,0,3,50,11,18.18,42,35,54.55
654,Clark Bishop,CAR,C,20,189.1333333,1,2,2,0,3,37.5,16,6.25,69,78,46.94
657,Anders Bjork,BOS,L,20,235.9833333,1,2,1,1,3,37.5,18,5.56,1,0,100
728,Dean Kukan,CBJ,D,16,206.3666667,0,3,1,2,3,75,9,0,0,0,-
756,Joey Anderson,N.J,R,23,287.8833333,2,1,1,0,3,42.86,31,6.45,3,3,50
780,Jordan Kyrou,STL,C,16,154.55,1,2,2,0,3,75,16,6.25,2,0,100
837,Oscar Fantenberg,"CGY, L.A",D,49,783.1666667,2,1,1,0,3,14.29,58,3.45,0,0,-
10,Matt Hendricks,MIN,C,22,197.6166667,0,2,2,0,2,50,20,0,41,35,53.95
83,Martin Hanzal,DAL,C,7,90.05,1,1,1,0,2,40,14,7.14,45,31,59.21
95,Chris Butler,STL,D,13,182.5,1,1,1,0,2,28.57,10,10,0,0,-
96,Tom Pyatt,OTT,L,37,433.4,0,2,1,1,2,33.33,29,0,56,92,37.84
125,Korbinian Holzer,ANA,D,9,138.8833333,0,2,0,2,2,33.33,6,0,0,0,-
133,David Schlemko,MTL,D,18,357.2,0,2,1,1,2,12.5,29,0,0,0,-
221,Luke Witkowski,DET,R,21,179.7,0,2,2,0,2,33.33,9,0,0,0,-
280,Jordan Nolan,STL,C,14,111.1333333,0,2,1,1,2,28.57,17,0,0,1,0
283,Darren Archibald,"OTT, VAN",R,12,88.5,1,1,0,1,2,66.67,10,10,0,1,0
286,Andrew Agozzino,COL,L,6,50.5,1,1,0,1,2,66.67,4,25,9,10,47.37
311,Alex Petrovic,"EDM, FLA",D,35,578.4166667,0,2,0,2,2,18.18,47,0,0,0,-
361,Scott Wilson,BUF,L,8,90.85,0,2,2,0,2,100,15,0,1,1,50
380,Andy Welinski,ANA,D,19,276.4666667,0,2,1,1,2,25,21,0,0,0,-
453,Jordan Schmaltz,STL,D,20,229.7166667,0,2,2,0,2,33.33,11,0,0,0,-
516,Chad Ruhwedel,PIT,D,18,292.9666667,1,1,0,1,2,33.33,22,4.55,0,0,-
519,Tyler Lewington,WSH,D,2,27.58333333,1,1,0,1,2,66.67,3,33.33,0,0,-
526,Jonny Brodzinski,L.A,L,7,78.88333333,1,1,1,0,2,66.67,11,9.09,1,1,50
538,Nick Paul,OTT,L,20,169.4833333,1,1,0,1,2,50,30,3.33,16,19,45.71
629,Joshua Ho-Sang,NYI,R,10,145.2333333,1,1,1,0,2,33.33,10,10,0,1,0
668,Danick Martel,T.B,L,8,78.26666667,0,2,2,0,2,50,15,0,1,1,50
688,A.J. Greer,COL,L,15,94.01666667,1,1,1,0,2,100,9,11.11,2,3,40
733,Mikhail Vorobyev,PHI,C,15,140,1,1,0,1,2,33.33,10,10,25,46,35.21
747,Philippe Myers,PHI,D,9,144.5833333,1,1,0,1,2,33.33,11,9.09,0,0,-
776,Max Jones,ANA,L,17,231.5333333,1,1,0,1,2,22.22,32,3.13,1,2,33.33
813,Juuso Valimaki,CGY,D,22,331.9833333,1,1,0,1,2,22.22,23,4.35,0,0,-
814,Kailer Yamamoto,EDM,R,17,222.0333333,1,1,1,0,2,40,13,7.69,0,0,-
821,Eeli Tolvanen,NSH,R,4,53.08333333,1,1,0,1,2,66.67,2,50,0,0,-
828,Martin Necas,CAR,C,7,70.16666667,1,1,0,1,2,100,6,16.67,16,28,36.36
832,C.J. Smith,BUF,L,11,117.2,2,0,0,0,2,66.67,18,11.11,0,0,-
852,Isac Lundestrom,ANA,C,15,195.4333333,0,2,1,1,2,33.33,13,0,21,43,32.81
853,Filip Zadina,DET,R,6,90.66666667,1,1,0,1,2,66.67,14,7.14,3,2,60
857,Karson Kuhlman,BOS,C,5,60.41666667,1,1,0,1,2,100,4,25,1,0,100
18,Tomas Plekanec,MTL,C,3,32.63333333,1,0,0,0,1,50,8,12.5,19,19,50
69,Andrej Sekera,EDM,D,10,156.8333333,0,1,0,1,1,14.29,10,0,0,0,-
74,Matt Hunwick,BUF,D,11,167.65,0,1,1,0,1,50,8,0,0,0,-
76,Cody McLeod,"NSH, NYR",L,37,243.2,1,0,0,0,1,25,22,4.55,0,1,0
116,Matt Beleskey,NYR,L,4,29.48333333,1,0,0,0,1,100,3,33.33,1,0,100
130,Erik Condra,DAL,R,6,76.1,1,0,0,0,1,100,10,10,0,1,0
137,Karl Alzner,MTL,D,9,155.7,0,1,1,0,1,25,8,0,0,0,-
182,Jason Garrison,EDM,D,17,215.8333333,1,0,0,0,1,14.29,16,6.25,0,0,-
187,Luke Schenn,"ANA, VAN",D,15,187.0666667,0,1,0,1,1,33.33,16,0,0,0,-
193,Luca Sbisa,NYI,D,9,139.2166667,0,1,0,1,1,25,5,0,0,0,-
202,Zac Dalpe,CBJ,C,1,9.016666667,0,1,1,0,1,100,1,0,0,1,0
209,Matt Donovan,NSH,D,2,14.78333333,0,1,0,1,1,100,1,0,0,0,-
220,Mark Barberio,COL,D,12,182.7,1,0,0,0,1,20,11,9.09,0,0,-
223,Matt Bartkowski,MIN,D,2,21.4,1,0,0,0,1,50,2,50,0,0,-
224,Dalton Prout,CGY,D,15,186.9333333,0,1,1,0,1,14.29,11,0,0,0,-
257,Stefan Elliott,OTT,D,3,26.95,0,1,0,1,1,50,3,0,0,0,-
272,Wade Megan,DET,C,11,86.65,0,1,1,0,1,50,16,0,28,23,54.9
282,Justin Dowling,DAL,C,6,75.66666667,0,1,1,0,1,33.33,5,0,12,14,46.15
345,Brandon Davidson,CHI,D,10,137.9333333,0,1,0,1,1,33.33,7,0,0,0,-
353,Matt Read,MIN,R,7,84.48333333,1,0,0,0,1,20,8,12.5,2,2,50
364,Max McCormick,OTT,L,14,105,1,0,0,0,1,100,12,8.33,0,1,0
371,Blake Pietila,N.J,L,13,155.6166667,0,1,1,0,1,100,11,0,14,10,58.33
383,Kyle Rau,MIN,C,6,42.08333333,0,1,0,1,1,100,6,0,3,1,75
414,Ryan Murphy,"MIN, N.J",D,3,33.5,0,1,1,0,1,50,1,0,0,0,-
434,Cameron Schilling,WPG,D,4,48.38333333,0,1,0,1,1,50,2,0,0,0,-
487,Dominic Toninato,COL,C,2,13.4,1,0,0,0,1,100,1,100,0,4,0
501,Jake Dotchin,ANA,D,20,236.1833333,0,1,1,0,1,16.67,7,0,0,0,-
510,Ashton Sautner,VAN,D,9,109.6833333,0,1,0,1,1,25,9,0,0,0,-
525,Luke Johnson,CHI,C,15,162.1833333,0,1,0,1,1,33.33,19,0,51,55,48.11
547,Ian McCoshen,FLA,D,18,240.2166667,1,0,0,0,1,12.5,12,8.33,0,0,-
553,Remi Elie,BUF,L,16,165.6,0,1,0,1,1,100,9,0,1,0,100
557,Dillon Heatherington,DAL,D,5,50.93333333,0,1,1,0,1,20,5,0,0,0,-
589,Nathan Walker,WSH,L,3,24.43333333,0,1,1,0,1,100,2,0,0,0,-
597,Daniel Carr,VGK,L,6,58.95,1,0,0,0,1,50,11,9.09,0,0,-
609,Haydn Fleury,CAR,D,14,175.6333333,0,1,1,0,1,8.33,10,0,0,0,-
618,Sonny Milano,CBJ,L,8,66.56666667,1,0,0,0,1,33.33,5,20,0,0,-
627,Nikita Scherbak,L.A,R,8,81.41666667,1,0,0,0,1,50,12,8.33,0,0,-
652,Michael Bunting,ARI,L,5,47.78333333,1,0,0,0,1,100,5,20,0,0,-
658,Rourke Chartier,S.J,C,13,122.2333333,1,0,0,0,1,50,19,5.26,34,51,40
689,Brendan Guhle,"ANA, BUF",D,7,114.0833333,0,1,1,0,1,50,15,0,0,0,-
709,Jeremy Lauzon,BOS,D,15,232.9333333,1,0,0,0,1,33.33,10,10,0,0,-
749,Tanner Fritz,NYI,C,4,42.86666667,0,1,1,0,1,100,3,0,7,5,58.33
752,Kalle Kossila,ANA,C,8,82.43333333,1,0,0,0,1,100,11,9.09,30,28,51.72
763,Libor Hajek,NYR,D,5,82.65,1,0,0,0,1,33.33,10,10,0,0,-
764,Carl Grundstrom,L.A,R,1,13.05,1,0,0,0,1,100,1,100,0,0,-
789,Nathan Bastian,N.J,R,4,50.25,1,0,0,0,1,100,6,16.67,3,0,100
790,Michael McLeod,N.J,C,8,102.9833333,0,1,0,1,1,50,4,0,40,31,56.34
791,Ben Gleason,DAL,D,4,59.51666667,0,1,1,0,1,50,2,0,0,0,-
794,Jacob MacDonald,FLA,D,2,24.1,1,0,0,0,1,100,1,100,0,0,-
807,Zack MacEwen,VAN,C,4,28.73333333,0,1,1,0,1,100,2,0,0,1,0
816,Jaret Anderson-Dolan,L.A,C,5,58.01666667,0,1,1,0,1,50,6,0,4,5,44.44
820,Kristian Vesalainen,WPG,L,5,34.2,0,1,0,1,1,100,1,0,0,0,-
824,Alex Formenton,OTT,L,9,105.0166667,1,0,0,0,1,33.33,16,6.25,1,2,33.33
847,Daniel Brickley,L.A,D,4,51.23333333,0,1,1,0,1,50,2,0,0,0,-
851,Evan Bouchard,EDM,D,7,86.48333333,1,0,0,0,1,50,10,10,0,0,-
5,Derek MacKenzie,FLA,C,1,2.716666667,0,0,0,0,0,-,0,-,2,1,66.67
16,Chris Thorburn,STL,R,1,1.866666667,0,0,0,0,0,-,0,-,0,0,-
43,Patrick Eaves,ANA,R,7,97.15,0,0,0,0,0,0,6,0,0,0,-
48,Lee Stempniak,BOS,R,1,7.766666667,0,0,0,0,0,-,0,-,0,0,-
50,Marc Methot,DAL,D,9,152.4666667,0,0,0,0,0,0,3,0,0,0,-
75,Adam Cracknell,ANA,R,2,20.86666667,0,0,0,0,0,-,3,0,0,0,-
104,Stephen Gionta,NYI,"C, R",5,43.91666667,0,0,0,0,0,-,4,0,20,17,54.05
114,Eric Gryba,N.J,D,10,152.95,0,0,0,0,0,0,11,0,0,0,-
134,Mark Letestu,CBJ,C,2,18.66666667,0,0,0,0,0,0,1,0,5,1,83.33
138,Justin Falk,OTT,D,10,129.25,0,0,0,0,0,0,7,0,0,0,-
141,Paul Carey,OTT,C,5,45.68333333,0,0,0,0,0,-,1,0,1,3,25
144,Eric Tangradi,N.J,L,1,15.41666667,0,0,0,0,0,-,3,0,0,0,-
153,Anthony Peluso,CGY,R,4,16.45,0,0,0,0,0,-,1,0,0,0,-
157,Brad Malone,EDM,C,12,106.8666667,0,0,0,0,0,-,11,0,22,27,44.9
199,Cody Goloubef,OTT,D,4,39.5,0,0,0,0,0,-,2,0,0,0,-
271,Corban Knight,PHI,C,9,94.05,0,0,0,0,0,-,9,0,25,21,54.35
288,Nate Prosser,MIN,D,15,153.3333333,0,0,0,0,0,0,10,0,0,0,-
295,Justin Holl,TOR,D,4,54.88333333,0,0,0,0,0,0,0,-,0,0,-
300,Mark Alt,COL,D,2,19.81666667,0,0,0,0,0,-,2,0,0,0,-
339,Sam Carrick,ANA,C,5,49.26666667,0,0,0,0,0,-,4,0,13,12,52
346,Zach Trotman,PIT,D,6,88.46666667,0,0,0,0,0,0,5,0,0,0,-
350,Erik Burgdoerfer,OTT,D,4,42.68333333,0,0,0,0,0,-,2,0,0,0,-
355,Cory Conacher,T.B,C,1,8.583333333,0,0,0,0,0,-,1,0,0,0,-
357,Colin Blackwell,NSH,C,6,58.43333333,0,0,0,0,0,-,5,0,13,16,44.83
378,Steven Fogarty,NYR,C,10,77.6,0,0,0,0,0,0,9,0,8,19,29.63
386,Reid Boucher,VAN,C,1,5.466666667,0,0,0,0,0,-,0,-,0,0,-
390,Adam Clendening,CBJ,D,4,42.61666667,0,0,0,0,0,0,3,0,0,0,-
436,Matt Tennyson,BUF,D,4,42.98333333,0,0,0,0,0,0,4,0,0,0,-
488,Trevor Carrick,CAR,D,1,11.48333333,0,0,0,0,0,-,0,-,0,0,-
493,Kevin Roy,ANA,L,3,39.13333333,0,0,0,0,0,-,2,0,0,0,-
497,Danny O'Regan,BUF,C,1,11.93333333,0,0,0,0,0,-,2,0,1,0,100
502,Joseph Blandisi,"ANA, PIT",C,4,38.73333333,0,0,0,0,0,0,3,0,0,0,-
509,Kurtis MacDermid,L.A,D,2,25.66666667,0,0,0,0,0,0,1,0,0,0,-
511,Andrej Sustr,ANA,D,5,60.2,0,0,0,0,0,0,6,0,0,0,-
524,Connor Clifton,BOS,D,9,157,0,0,0,0,0,0,6,0,0,0,-
527,Josh Brown,FLA,D,23,289.2166667,0,0,0,0,0,0,13,0,0,0,-
528,Tyrell Goulbourne,PHI,L,2,14.81666667,0,0,0,0,0,-,3,0,0,0,-
544,Marko Dano,COL,C,8,55.06666667,0,0,0,0,0,0,3,0,0,5,0
552,Laurent Dauphin,ARI,C,1,12.31666667,0,0,0,0,0,-,2,0,0,1,0
559,Justin Bailey,PHI,R,6,34.08333333,0,0,0,0,0,0,2,0,0,0,-
582,Kerby Rychel,CGY,L,2,18.35,0,0,0,0,0,0,1,0,0,1,0
588,Dakota Mermis,ARI,D,1,11.33333333,0,0,0,0,0,0,0,-,0,0,-
591,Joel Hanley,DAL,D,16,219.0833333,0,0,0,0,0,0,9,0,0,0,-
631,John Quenneville,N.J,C,17,188.8,0,0,0,0,0,0,12,0,4,6,40
637,Nicolas Aube-Kubel,PHI,R,9,50.3,0,0,0,0,0,0,2,0,0,0,-
644,Louie Belpedio,MIN,D,2,26.26666667,0,0,0,0,0,0,0,-,0,0,-
647,Nelson Nogier,WPG,D,1,10.1,0,0,0,0,0,-,1,0,0,0,-
656,Anton Lindholm,COL,D,2,14.35,0,0,0,0,0,-,0,-,0,0,-
663,Jacob Middleton,S.J,D,1,5.033333333,0,0,0,0,0,-,0,-,0,0,-
664,Joe Hicketts,DET,D,8,136.75,0,0,0,0,0,0,9,0,0,0,-
667,Jack Rodewald,OTT,R,6,42.36666667,0,0,0,0,0,-,2,0,0,0,-
670,Nikita Soshnikov,STL,R,5,35.83333333,0,0,0,0,0,0,1,0,0,0,-
681,Anthony Richard,NSH,C,1,7.366666667,0,0,0,0,0,-,0,-,0,0,-
684,Jakub Zboril,BOS,D,2,21.86666667,0,0,0,0,0,-,1,0,0,0,-
695,Cooper Marody,EDM,C,6,41.46666667,0,0,0,0,0,-,6,0,9,17,34.62
705,Nicolas Roy,CAR,C,6,41.7,0,0,0,0,0,-,1,0,21,18,53.85
707,Guillaume Brisebois,VAN,D,2,16.4,0,0,0,0,0,-,1,0,0,0,-
713,Kyle Capobianco,ARI,D,2,32.15,0,0,0,0,0,-,1,0,0,0,-
715,Filip Chlapik,OTT,C,3,39.03333333,0,0,0,0,0,0,5,0,6,4,60
721,Gabriel Carlsson,CBJ,D,1,9.35,0,0,0,0,0,-,1,0,0,0,-
731,Kevin Stenlund,CBJ,C,4,43.85,0,0,0,0,0,-,3,0,3,3,50
744,Matt Roy,L.A,D,11,182.6833333,0,0,0,0,0,0,15,0,0,0,-
746,Kole Sherwood,CBJ,R,2,18.45,0,0,0,0,0,-,2,0,0,0,-
748,Ryan Lomberg,CGY,L,4,27.93333333,0,0,0,0,0,-,1,0,0,0,-
750,Nick Lappin,N.J,R,9,125.1666667,0,0,0,0,0,0,11,0,4,1,80
760,Ryan Lindgren,NYR,D,3,41.16666667,0,0,0,0,0,0,3,0,0,0,-
762,Brandon Gignac,N.J,C,1,9.066666667,0,0,0,0,0,-,1,0,0,0,-
773,Timothy Gettinger,NYR,L,4,30.08333333,0,0,0,0,0,0,2,0,0,0,-
774,Trent Frederic,BOS,C,11,103.2,0,0,0,0,0,0,13,0,29,24,54.72
775,Logan Brown,OTT,C,2,21.03333333,0,0,0,0,0,-,2,0,2,6,25
781,Riley Stillman,FLA,D,1,11.36666667,0,0,0,0,0,0,1,0,0,0,-
785,Jake Bean,CAR,D,2,16.91666667,0,0,0,0,0,-,1,0,0,0,-
796,Anthony Greco,FLA,R,1,9.5,0,0,0,0,0,-,2,0,0,0,-
799,Patrick Russell,EDM,R,6,52.73333333,0,0,0,0,0,-,6,0,0,0,-
801,Janne Kuokkanen,CAR,L,7,76.43333333,0,0,0,0,0,0,6,0,0,0,-
802,Maxim Mamin,FLA,C,7,51.43333333,0,0,0,0,0,-,8,0,0,1,0
803,Dylan Gambrell,S.J,C,6,49.13333333,0,0,0,0,0,0,4,0,13,15,46.43
810,Vinni Lettieri,NYR,C,18,155.4666667,0,0,0,0,0,0,21,0,6,4,60
811,Joseph Gambardella,EDM,C,4,23.26666667,0,0,0,0,0,-,0,-,0,0,-
818,Urho Vaakanainen,BOS,D,2,18.2,0,0,0,0,0,-,2,0,0,0,-
831,Justin Kloos,ANA,C,1,7.066666667,0,0,0,0,0,-,2,0,0,0,-
834,Jakub Jerabek,STL,D,1,7.866666667,0,0,0,0,0,-,1,0,0,0,-
839,Libor Sulak,DET,D,6,116.2833333,0,0,0,0,0,0,7,0,0,0,-
845,Eric Robinson,CBJ,L,11,139.1833333,0,0,0,0,0,0,15,0,0,0,-
846,Joel L'Esperance,DAL,C,9,106.6,0,0,0,0,0,0,10,0,21,18,53.85
848,Sheldon Rempal,L.A,R,7,61.16666667,0,0,0,0,0,0,3,0,0,0,-
865,Jacob Nilsson,CHI,C,2,15.71666667,0,0,0,0,0,-,0,-,3,5,37.5
868,Logan O'Connor,COL,R,5,34.06666667,0,0,0,0,0,-,1,0,0,3,0